Your good friend Luigi has invited you to go camping with him over the weekend to Axe Creek, an abondoned camp site infamous for its reports of mysterious casualties and missing persons. Being a timid and not-so adventurous person, it took lots of convincing before you agreed to go. You decided that this could be your chance to prove to yourself that you're not a big baby. You can survive a single weekend in the woods, right?

Cowardice
A not-so-spooky interactive fiction. by Lee-Won Fulbright The release number is 1
Release 1 / Serial number 141028 / Inform 7 build 6L38 (I6/v6.33 lib 6/12N) SD

Campsite
The campsite is surrounded with greenery. In the center of the camp is a roaring fire. Luigi is lounging around the campsite. He seems to be carrying some kind of flat, wooden object. You should try talking to him first. 

 Your pitched tent is South. North is the Forest Clearing.

>talk to Luigi
Luigi: Yo! Feel free to ask me about stuff. 

 You can ask Luigi about Tent, Campsite, Board, Himself, Yourself, etc.

>ask luigi about campsite
Luigi: They say this whole area is haunted. I heard there were even series of murders commited in that cabin up north. 

 You can ask Luigi about Murders, Tent, object, Himself, Cabin, Yourself, etc.

>ask luigi about murders
Luigi: Most of the stories weren't disclosed to the public, but I heard they were all  axe murders.  Haha, sorry, I know you get freaked out pretty easily. Don't worry, though, all the murders happened a really long time ago. The killer's long dead by now, though some people say that his spirit haunts this creek to this day. That's why this place is called Axe Creek.

 You can ask Luigi about Tent, object, Himself, Cabin, Yourself, etc..

>ask luigi about himself
Luigi: I love camping! All this fun is making me a bit thirsty, though. Maybe you can get me something to drink?

>ask luigi about yourself
Luigi: I can't believe you had the guts to come camping out here! You're definitely not the bravest person I've ever met.

>ask luigi about object
Luigi: It's a ouija board! Hey, I'll let you take a look at it if you get me something to drink. I'm a bit parched. 

 You can ask Luigi about Ouija Board, Tent, Campsite, Himself, Yourself, etc.

>ask luigi about ouija board
Luigi: They're so cool! I found this one buried in the dirt while I was nailing the tent into the ground. I guess I was meant to find it! Hm, maybe I'll let you take a look at it if you get me something to drink.

>ask luigi about drink
There is no reply.

>x campsite
You can't see any such thing.

>x cabin
You can't see any such thing.

>ask luigi about cabin
Luigi: Some creepy old cabin. I wonder who used to live there.  Bet you're too chicken to investigate.  

 You can ask Luigi about Tent, Object, Campsite, Himself, Yourself, etc.

>n
Forest Clearing
Here there is a lack of trees, giving a view of the stars. In the center of the clearing, there is an oddly symmetrical pond. Now that you look around, you realize that the trees on the perimeter of the surrounding fields are very similar, but don't quite mirror each other.

 You can see two paths on either side of the clearing. West is Western Field, and East is Eastern Field. You can see the cabin up ahead. North is to the cabin's front door. The path South leads to the Campsite.

>n
Cabin
 You enter the abandoned cabin.  The room has peeling walls and a rotten wooden floor. Both seem to be splattered with a dark stain. There is no furniture in the room, besides a single book lying in the middle of the floor. 

 North of this room is the Attic. East of here is an open door leading to what looks like a bedroom.  South is Forest Clearing.

>s
Forest Clearing
Here there is a lack of trees, giving a view of the stars. In the center of the clearing, there is an oddly symmetrical pond. Now that you look around, you realize that the trees on the perimeter of the surrounding fields are very similar, but don't quite mirror each other.

 You can see two paths on either side of the clearing. West is Western Field, and East is Eastern Field. You can see the cabin up ahead. North is to the cabin's front door. The path South leads to the Campsite.

>s
Campsite
The campsite is surrounded with greenery. In the center of the camp is a roaring fire. Luigi is lounging around the campsite. He seems to be carrying some kind of flat, wooden object. You should try talking to him first. 

 Your pitched tent is South. North is the Forest Clearing.

>s
Tent
Your backpack sits in the corner. The sleeping bags are unrolled on the ground.

 North is the Campsite.

>n
Campsite
The campsite is surrounded with greenery. In the center of the camp is a roaring fire. Luigi is lounging around the campsite. He seems to be carrying some kind of flat, wooden object. You should try talking to him first. 

 Your pitched tent is South. North is the Forest Clearing.

>n
Forest Clearing
Here there is a lack of trees, giving a view of the stars. In the center of the clearing, there is an oddly symmetrical pond. Now that you look around, you realize that the trees on the perimeter of the surrounding fields are very similar, but don't quite mirror each other.

 You can see two paths on either side of the clearing. West is Western Field, and East is Eastern Field. You can see the cabin up ahead. North is to the cabin's front door. The path South leads to the Campsite.

>n
Cabin
 The room has peeling walls and a rotten wooden floor. Both seem to be splattered with a dark stain. There is no furniture in the room, besides a single book lying in the middle of the floor. 

 North of this room is the Attic. East of here is an open door leading to what looks like a bedroom.  South is Forest Clearing.

>n
(first opening attic door)
It seems to be locked.

>s
Forest Clearing
Here there is a lack of trees, giving a view of the stars. In the center of the clearing, there is an oddly symmetrical pond. Now that you look around, you realize that the trees on the perimeter of the surrounding fields are very similar, but don't quite mirror each other.

 You can see two paths on either side of the clearing. West is Western Field, and East is Eastern Field. You can see the cabin up ahead. North is to the cabin's front door. The path South leads to the Campsite.

* * *

>s
Tent
Your backpack sits in the corner. The sleeping bags are unrolled on the ground.

 North is the Campsite.

>x backpack
Your small backpack containing your essentials for the weekend.

>open backpack
You open the Backpack, revealing a Canteen.

>x canteen
It's empty.

>n
Campsite
The campsite is surrounded with greenery. In the center of the camp is a roaring fire. Luigi is lounging around the campsite. He seems to be carrying some kind of flat, wooden object. You should try talking to him first. 

 Your pitched tent is South. North is the Forest Clearing.

>s
Tent
Your backpack sits in the corner. The sleeping bags are unrolled on the ground.

 North is the Campsite.

>open backpack
That's already open.

>take canteen
Taken.

>n
Campsite
The campsite is surrounded with greenery. In the center of the camp is a roaring fire. Luigi is lounging around the campsite. He seems to be carrying some kind of flat, wooden object. You should try talking to him first. 

 Your pitched tent is South. North is the Forest Clearing.

* * *

>n
Forest Clearing
Here there is a lack of trees, giving a view of the stars. In the center of the clearing, there is an oddly symmetrical pond. Now that you look around, you realize that the trees on the perimeter of the surrounding fields are very similar, but don't quite mirror each other.

 You can see two paths on either side of the clearing. West is Western Field, and East is Eastern Field. You can see the cabin up ahead. North is to the cabin's front door. The path South leads to the Campsite.

>x pond
The perfect-circle pond is serene, and so clear that you can see the bottom. There seems to be nothing alive in the pond.

>fill canteen
You can only fill the canteen with water. And, you have to be in water to fill it.

>go into pond
You get onto the Pond.

>fill canteen
You filled the canteen with the pond water.
The canteen is full.

>s
(first getting off the Pond)

Campsite
The campsite is surrounded with greenery. In the center of the camp is a roaring fire. Luigi is lounging around the campsite. He seems to be carrying some kind of flat, wooden object. You should try talking to him first. 

 Your pitched tent is South. North is the Forest Clearing.

>give canteen to Luigi
Luigi: Yo, thanks! Here's the board, as promised. I forgot to mention that I don't know how to open the board. It's like it's magically shut!  No matter what I do, I can't seem to get it open. Maybe you have some idea of how to do it?

 You are now carrying the Ouija Board.

>open board
Like Luigi said, the Board is closed shut like magic. Maybe you can find a way to open it.

>x board
It seems to be an old fashioned ouija board.

>take board
You are already carrying the Ouija Board.

>s
Tent
Your backpack sits in the corner. The sleeping bags are unrolled on the ground.

 North is the Campsite.

Luigi is with you.

>n
Campsite
The campsite is surrounded with greenery. In the center of the camp is a roaring fire.

 Your pitched tent is South. North is the Forest Clearing.

Luigi is with you.

>n
Forest Clearing
Here there is a lack of trees, giving a view of the stars. In the center of the clearing, there is an oddly symmetrical pond. Now that you look around, you realize that the trees on the perimeter of the surrounding fields are very similar, but don't quite mirror each other.

 You can see two paths on either side of the clearing. West is Western Field, and East is Eastern Field. You can see the cabin up ahead. North is to the cabin's front door. The path South leads to the Campsite.

Luigi is with you.

>w
Western Field
There is an interesting formation of trees on the far end of the field.

 East is Forest Clearing.

Luigi is with you.

>e
Forest Clearing
Here there is a lack of trees, giving a view of the stars. In the center of the clearing, there is an oddly symmetrical pond. Now that you look around, you realize that the trees on the perimeter of the surrounding fields are very similar, but don't quite mirror each other.

 You can see two paths on either side of the clearing. West is Western Field, and East is Eastern Field. You can see the cabin up ahead. North is to the cabin's front door. The path South leads to the Campsite.

Luigi is with you.

>s
Campsite
The campsite is surrounded with greenery. In the center of the camp is a roaring fire.

 Your pitched tent is South. North is the Forest Clearing.

Luigi is with you.

>x board
It seems to be an old fashioned ouija board.

>open board
Like Luigi said, the Board is closed shut like magic. Maybe you can find a way to open it.

>w
You can't go that way.

>e
You can't go that way.

>n
Forest Clearing
Here there is a lack of trees, giving a view of the stars. In the center of the clearing, there is an oddly symmetrical pond. Now that you look around, you realize that the trees on the perimeter of the surrounding fields are very similar, but don't quite mirror each other.

 You can see two paths on either side of the clearing. West is Western Field, and East is Eastern Field. You can see the cabin up ahead. North is to the cabin's front door. The path South leads to the Campsite.

Luigi is with you.

* * *

>w
Western Field
There is an interesting formation of trees on the far end of the field.

 East is Forest Clearing.

Luigi is with you.

>x trees
You see five identical birch trees (name: Western Birch Trees), all growing in a straight row. On one end of the row of trees, there is a tree stump.

>x stump
It looks like it was cut clean with an axe. From looking at the wood, you assume the stump used to be an oak tree.

>x tree
It looks like it was cut clean with an axe. From looking at the wood, you assume the stump used to be an oak tree.

>x trees
You see five identical birch trees (name: Western Birch Trees), all growing in a straight row. On one end of the row of trees, there is a tree stump.

>x formation
You can't see any such thing.

>e
Forest Clearing
Here there is a lack of trees, giving a view of the stars. In the center of the clearing, there is an oddly symmetrical pond. Now that you look around, you realize that the trees on the perimeter of the surrounding fields are very similar, but don't quite mirror each other.

 You can see two paths on either side of the clearing. West is Western Field, and East is Eastern Field. You can see the cabin up ahead. North is to the cabin's front door. The path South leads to the Campsite.

Luigi is with you.

>e
Eastern Field
There is an interesting formation of trees on the far end of the field.

 West is Forest Clearing.

Luigi is with you.

>x trees
You see five identical birch trees (name: Eastern Birch Trees), all growing in a straight row. On one end of the row of trees, there is an oak tree, where, in the Western Field, there is a stump.

>x oak tree
The tall oak tree looks out of place in the Eastern Field.

>n
You can't go that way.

>w
Forest Clearing
Here there is a lack of trees, giving a view of the stars. In the center of the clearing, there is an oddly symmetrical pond. Now that you look around, you realize that the trees on the perimeter of the surrounding fields are very similar, but don't quite mirror each other.

 You can see two paths on either side of the clearing. West is Western Field, and East is Eastern Field. You can see the cabin up ahead. North is to the cabin's front door. The path South leads to the Campsite.

Luigi is with you.

>n
Cabin
 The room has peeling walls and a rotten wooden floor. Both seem to be splattered with a dark stain. There is no furniture in the room, besides a single book lying in the middle of the floor. 

 North of this room is the Attic. East of here is an open door leading to what looks like a bedroom.  South is Forest Clearing.

Luigi is with you.

>n
(first opening attic door)
It seems to be locked.

>x door
You see nothing special about attic door.

>x book
An odd, worn book. The cover reads:  Beware of Ouija.  There seems to be four pages in the Ouija Book, though many of the words are smudged and indecipherable. Start by reading page 1 of Ouija Book.

>x page 1
You can't see any such thing.

>read page 1
(in ouija board)
There are no pages in ouija board.

>take book
Taken.

>read
What do you want to read?

>page 1
What do you want to read page that in?

>read page 1 of book
You read: " Entry One of Four. xx/xx/xxxx.  I am writing this diary to record my investigations of the axe murder house, located in this very forest in xxxxxxx. I am the famous paranormal invesitgator, xxxx xxxxxxxx. I have come here with the intentions of contacting the spirit of the axe murderer, xxxxxxxx xxx, who died in these woods xx years ago. Reasons behind these murders as well as facts on the killer are unknown. To uncover these mysteries, I plan to contact the spirit of the murderer himself using my ouija board. Also known as the Witch Board, the Ouija Board is an ancient tool used to form a connection with the departed, first used by the Chinese in 1100 AD. Tomorrow night, here in the cabin, I will attempt to make spiritual contact through the board."

>read page 2 of book
You read: " Entry Two of Four. xx/xx/xxxx.  Night has fallen, and I am ready to open the board and begin communication with xxxxxxxx xxx. I am quite proud of my special Ouija board. It is unique in that you must knock three times on the board to open it. This insures that not just anyone can have easy access to the board, as using a ouija board is quite dangerous. After opening the board, I will place my hands on the planchette and ready myself both mentally and physically to encounter xxxxxxxx xxx's malevolent spirit. Anyone who's used a ouija board before knows that if the planchette moves to each of the four corners of the board, you have contacted an evil spirit. So, that's what I'm keeping an eye out for while I'm searching for the axe murderer's spirit."

>read page 3 of book
You read: " Entry Three of Four. xx/xx/xxxx.  I did it-- I reached the spirit of xxxxxxxx xxx. His spirit is unlike any I have come into contact with. It responds much faster, and with much greater intelligence than those of most entities. It is powerful, that much is apparent. I must remain wary of xxxxxxxx xxx's malicious intent; false flattery and lies are only to be expected from the likes of it. If anything begins to go wrong, I will simply exit the conversation by moving the planchette to the part of the board "GOOD BYE", which should sever the connection between the spirit and myself. Let this be a reminder to myself and a warning to anyone reading this:  If the spirit should somehow possess an object/body, do NOT ATTEMPT TO KILL IT. This will only result in eminent death. Evil spirits are not to be reckoned with. My goal is to inquire about the final resting place of xxxxxxxx xxx, find the remains, and burn them. Hopefully, by doing this, the spirit will be put to rest."

>read page 4 of book
You read: " Final Entry. xx/xx/xxxx.  N o ! This cannot be happening! I have lost control of the planchette, and am unable to exit through the normal means of "GOODBYE". I was a fool. I was nave. The spirit was too cunning. I am frant cally writing t is to anyo e who fi s my d ary or my ouija b ard. D o not fall vic im to the spir t! It wil turn y u agai st your friends. Be Brave.  And wha ever yo u do, do not destroy t e  o ija boa d!!!!"

>open board
Like Luigi said, the Board is closed shut like magic. Maybe you can find a way to open it.

>knock 3 times on board
You hear a click. The ouija board is now openable.

>move the planchette
You can't see any such thing.

>open board
You open the board as you would a book, and see that the inside is intact. It looks like the traditional Ouija Board, with the alphabet, numbers 0-9, "Yes" and "No" at the two top corners of the board. The planchette is fixed to the board in a way so that keeps it from falling off the board when used. Below the numbes, you read "GOOD BYE" in large letters. In the bottom hand corner of the board you read "Property of xxxx xxxxxxxx, Paranormal Investigator". 

 Luigi quietly comes up from behind you. 

 Luigi: YO! Heh, scared you didn't I? You jumped about six feet. Oh, you got the board open! I guess I'll follow you around now that things are getting interesting.Try asking the board about the spirit.

 Luigi is now following you.

>move planchette
You can't see any such thing.

>ask board about spirit
You place your hands on the planchette, and immediately after asking the question, the planchette smoothly moves to each of the four corners of the board. Then, after a moment, the planchette spells "i am here". 

 You can ask the board about the murderer, the paranormal investigator, or the remains.

>ask board about the paranormal investigator
This time, almost excitedly, the planchette spells "i killed him". Then, "axed". 

You can ask the board about the remains.

>ask board about murderer
the planchette spells the words "i am". 

 You can ask the board about the paranormal investigator or the remains.

>ask board about the remains
The planchette does not move for a while. Then, it slowly spells "make a mirror image". 

Luigi: What does it mean, make a mirror image? What is it asking us to do?

>ask about mirror image
You can't see any such thing.

>ask board about mirror image
The planchette remains still. 

Luigi: Try asking about a hint?

>ask board for hint
You can't see any such thing.

>ask board about a hint
There is no reply.

>ask board about hint
The planchette spells out "Axes make mirrors. Life and death are mirrors. Young and old, rich and poor.  East and West are mirrors as well. 

 Luigi: Something about East and West???

>ask board about east and west
There is no reply.

>ask board about mirrors
There is no reply.

>ask luigi about east and west
There is no reply.

>ask board about axe
There is no reply.

>l
Cabin
 The room has peeling walls and a rotten wooden floor. Both seem to be splattered with a dark stain. There is no furniture in the room. 

 North of this room is the Attic. East of here is an open door leading to what looks like a bedroom.  South is Forest Clearing.

>e
Bedroom
Besides a bed and a dresser, the room is barren. Like the first room in the cabin, it is covered in dust. 

West is the Cabin's entrance room.

Luigi is with you.

>x bed
A large, dusty bed. Smells a bit funky.

>x dresser
Even when covered with a thick coat of dust, you can see the outline of a single drawer.

>x drawer
Even when covered with a thick coat of dust, you can see the outline of a single drawer.

>open drawer
You open the drawer to reveal an old, rusted axe. On the inside of the drawer there are dark brown stains on the wood as well as on the axe blade.

>x axe
A gigantic axe. It looks like it was used very often, as the blade is a bit rusted and chipped. However, the axe seems to have retained its menacing look.

>take axe
Taken.

>leave room
I only understood you as far as wanting to leave.

>l
Bedroom
Besides a bed and a dresser, the room is barren. Like the first room in the cabin, it is covered in dust. 

West is the Cabin's entrance room.

>w
Cabin
 The room has peeling walls and a rotten wooden floor. Both seem to be splattered with a dark stain. There is no furniture in the room. 

 North of this room is the Attic. East of here is the Bedroom. South is Forest Clearing.

Luigi is with you.

>s
Forest Clearing
Here there is a lack of trees, giving a view of the stars. In the center of the clearing, there is an oddly symmetrical pond. Now that you look around, you realize that the trees on the perimeter of the surrounding fields are very similar, but don't quite mirror each other.

 You can see two paths on either side of the clearing. West is Western Field, and East is Eastern Field. You can see the cabin up ahead. North is to the cabin's front door. The path South leads to the Campsite.

Luigi is with you.

>l
Forest Clearing
Here there is a lack of trees, giving a view of the stars. In the center of the clearing, there is an oddly symmetrical pond. Now that you look around, you realize that the trees on the perimeter of the surrounding fields are very similar, but don't quite mirror each other.

 You can see two paths on either side of the clearing. West is Western Field, and East is Eastern Field. You can see the cabin up ahead. North is to the cabin's front door. The path South leads to the Campsite.

>w
Western Field
There is an interesting formation of trees on the far end of the field.

 East is Forest Clearing.

Luigi is with you.

* * *

>x trees
You see five identical birch trees (name: Western Birch Trees), all growing in a straight row. On one end of the row of trees, there is a tree stump.

>l
Western Field
There is an interesting formation of trees on the far end of the field.

 East is Forest Clearing.

>e
Forest Clearing
Here there is a lack of trees, giving a view of the stars. In the center of the clearing, there is an oddly symmetrical pond. Now that you look around, you realize that the trees on the perimeter of the surrounding fields are very similar, but don't quite mirror each other.

 You can see two paths on either side of the clearing. West is Western Field, and East is Eastern Field. You can see the cabin up ahead. North is to the cabin's front door. The path South leads to the Campsite.

Luigi is with you.

* * *

>e
Eastern Field
There is an interesting formation of trees on the far end of the field.

 West is Forest Clearing.

Luigi is with you.

>l
Eastern Field
There is an interesting formation of trees on the far end of the field.

 West is Forest Clearing.

>x trees
You see five identical birch trees (name: Eastern Birch Trees), all growing in a straight row. On one end of the row of trees, there is an oak tree, where, in the Western Field, there is a stump.

>chop down tree
You chop down the oak tree with the axe, making a tree stump just like the one in the Western field. A mirror image was made. From inside the stump, you see a wooden key.

>take key
After taking the wooden key, you notice that the planchette begins to move on its own. It spells "You are brave... Now go..."

>l
Eastern Field
There is an interesting formation of trees on the far end of the field.

 West is Forest Clearing.

>w
Forest Clearing
Here there is a lack of trees, giving a view of the stars. In the center of the clearing, there is an oddly symmetrical pond. 

 You can see two paths on either side of the clearing. West is Western Field, and East is Eastern Field. You can see the cabin up ahead. North is to the cabin's front door. The path South leads to the Campsite.

>n
Cabin
 The room has peeling walls and a rotten wooden floor. Both seem to be splattered with a dark stain. There is no furniture in the room. 

 North of this room is the Attic. East of here is the Bedroom. South is Forest Clearing.

>n
(first unlocking the attic door with the wooden key, then opening the door)

Attic
The Attic is dust covered and moldy. There is a single, round window overlooking the Creek.  In the center of the room, on the floor, is a skeleton. 

 South is the Cabin's entrance room.

>x skeleton
The skeleton that looks like it could have belonged to a large man. It is impossible to tell the cause of death. On the clothes of the skeleton, there is a name card.

>x card
You read, "xxxx xxxxxxxx, Paranormal Investigator. 

 The planchette moves one final time. Your heart feels like it has stopped when the planchette spells "You're next". You hear the attic door slam behind you.

 The skeletal remains of the Paranormal Investigator slowly animates, rising to its feet. It looks as if it is being possessed, no doubt by the spirit of the axe murderer. With startling ease, it begins to move towards you with murderous intent. You need to make a decision, and fast! For the first time, you notice a scrap of paper on the floor beside you. Picking it up, you read "Search the pond. There you will find the remains. You must burn the remains if you want to survive." Is this a dying message from the paranormal investigator?

 Luigi: What do we do?! You're not going to kill me, are you?! I say we chop down the skeleton!! Kill it before it kills us! 

You need to carefully (yet quickly) look at your surroundings and take note of your items. There is only one correct way out of this situation.

Luigi is with you.

>l
Attic
The Attic is dust covered and moldy. There is a single, round window overlooking the Creek. The possessed skeleton monster is slowly but surely making its way towards you from the center of the room. Time is running out. 

 South is the Cabin's entrance room.

>i
You are carrying:
  Paper
  Wooden Key
  axe
  ouija book
  ouija board

>chop skeleton
You finally feeling like you have become a brave person. In this proud moment, you swing your axe at the skull of the skeleton. However, the skeleton is swift to dodge your blow, and quickly overwhelms you. In a split second, you remember what the paranormal investigator had written in his book-- "If the spirit should somehow possess an object/body, do NOT ATTEMPT TO KILL IT. This will only result in eminent death."

 In an attempt to renounce your cowardice, you and Luigi die a pitiful death.

    *** BAD END. ***

Would you like to RESTART, RESTORE a saved game, QUIT or UNDO the last command?

>undo
Attic
[Previous turn undone.]

>l
Attic
The Attic is dust covered and moldy. There is a single, round window overlooking the Creek. The possessed skeleton monster is slowly but surely making its way towards you from the center of the room. Time is running out. 

 South is the Cabin's entrance room.

>s
The door is jammed, seemingly by some unknown force. The wooden key no longer works.

>i
You are carrying:
  Paper
  Wooden Key
  axe
  ouija book
  ouija board

>break board
With a single blow, you chop the Ouija Board in half. You have destroyed the board. However, by doing this, you have unleashed the evil spririt of xxxxxxxx xxx, and have unwittingly sent yourself to your own doom.

    *** BAD END. ***

Would you like to RESTART, RESTORE a saved game, QUIT or UNDO the last command?

>undo
Attic
[Previous turn undone.]

>i
You are carrying:
  Paper
  Wooden Key
  axe
  ouija book
  ouija board

>x paper
A crumpled piece of paper. It says "Search the pond. There you will find the remains. You must burn the remains if you want to survive." Is this a dying message from the paranormal investigator?

>l
Attic
The Attic is dust covered and moldy. There is a single, round window overlooking the Creek. The possessed skeleton monster is slowly but surely making its way towards you from the center of the room. Time is running out. 

 South is the Cabin's entrance room.

* * *

>s
The door is jammed, seemingly by some unknown force. The wooden key no longer works.

>break down door
You can't see any such thing.

>chop down door
With two quick swipes of your axe, you break down the attic door. You drop the axe, and run out of the cabin, into the forest clearing. You have made the brave, but intelligent decision. Now, you must save yourself and Luigi from the spirit of the axe murderer that possesses the skeleton of the paranormal investigator. Follow the investigator's instructions carefully, time is of the essence. You can hear the skeleton racing down the attic.

Forest Clearing
Here there is a lack of trees, giving a view of the stars. In the center of the clearing, there is an oddly symmetrical pond. Now that you look around, you realize that the trees on the perimeter of the surrounding fields are very similar, but don't quite mirror each other. The trees on the perimeter of the surrounding fields create a mirror image.

 You can see two paths on either side of the clearing. West is Western Field, and East is Eastern Field. You can see the cabin up ahead. North is to the cabin's front door. The path South leads to the Campsite.

Luigi is with you.

>i
You are carrying:
  Paper
  Wooden Key
  ouija book
  ouija board

>l
Forest Clearing
Here there is a lack of trees, giving a view of the stars. In the center of the clearing, there is an oddly symmetrical pond. Now that you look around, you realize that the trees on the perimeter of the surrounding fields are very similar, but don't quite mirror each other. The trees on the perimeter of the surrounding fields create a mirror image.

 You can see two paths on either side of the clearing. West is Western Field, and East is Eastern Field. You can see the cabin up ahead. North is to the cabin's front door. The path South leads to the Campsite.

>go to pond
You can't see any such thing.

>x trees
You can't see any such thing.

>x pond
The perfect-circle pond is serene, and so clear that you can see the bottom. There seems to be nothing alive in the pond.

>go into pond
You get onto the Pond.

>x bottom of pond
You can't see any such thing.

>read paper
There are no pages in Paper.

>x paper
A crumpled piece of paper. It says "Search the pond. There you will find the remains. You must burn the remains if you want to survive." Is this a dying message from the paranormal investigator?

>search pond
You follow the instructions on the piece of paper, and after digging around the pond, you see a large skull sunken beneath the surface.

>burn skul
You can't see any such thing.

>burn remains
This dangerous act would achieve little.

>take remains
Taken.

>get out of pond
You can't see any such thing.

>burn remains
This dangerous act would achieve little.

>l
Forest Clearing (on the Pond)
Here there is a lack of trees, giving a view of the stars. In the center of the clearing, there is an oddly symmetrical pond. Now that you look around, you realize that the trees on the perimeter of the surrounding fields are very similar, but don't quite mirror each other. The trees on the perimeter of the surrounding fields create a mirror image.

 You can see two paths on either side of the clearing. West is Western Field, and East is Eastern Field. You can see the cabin up ahead. North is to the cabin's front door. The path South leads to the Campsite.

>s
(first getting off the Pond)

Campsite
The campsite is surrounded with greenery. In the center of the camp is a roaring fire.

 Your pitched tent is South. North is the Forest Clearing.

Luigi is with you.

>throw remains into fire
That can't contain things.

>throw remains in fire
As you near the flames, you feel a growing nervousness and fear of the outcome. The planchette angrily moves rapidly from each of the corners of the board. The skeleton is almost upon you. You finally bring yourself to push away your fears, and throw the skull into the fire. The skeleton falls to pieces, and the planchette lays frozen on the board.

 Luigi: You did it... You saved us! I guess I have to admit you're not some big scaredy-cat after all.

    *** GOOD END. ***

Would you like to RESTART, RESTORE a saved game, QUIT or UNDO the last command?

* * *

I beg your pardon?

>n
Forest Clearing
Here there is a lack of trees, giving a view of the stars. In the center of the clearing, there is an oddly symmetrical pond. You can see that the trees on the perimeter of the surrounding fields are very similar, but don't quite mirror each other. 

 You can see two paths on either side of the clearing. West is Western Field, and East is Eastern Field. You can see the cabin up ahead. North is to the cabin's front door. The path South leads to the Campsite.

>s
Campsite
The campsite is surrounded with greenery. In the center of the camp is a roaring fire. Luigi is lounging around the campsite. He seems to be carrying some kind of flat, wooden object. You should try talking to him first. 

 Your pitched tent is South. North is the Forest Clearing.

>e
You can't go that way.

>r
That's not a verb I recognise.

>dj
That's not a verb I recognise.

>smell
You smell nothing unexpected.

>smell
You smell nothing unexpected.

>s
Tent
Your backpack sits in the corner. The sleeping bags are unrolled on the ground.

 North is the Campsite.

>s
You can't go that way.

>open backpack
You open the Backpack, revealing a Canteen.

>take canteen
Taken.

* * *

>n
Campsite
The campsite is surrounded with greenery. In the center of the camp is a roaring fire. Luigi is lounging around the campsite. He seems to be carrying some kind of flat, wooden object. You should try talking to him first. 

 Your pitched tent is South. North is the Forest Clearing.

>n
Forest Clearing
Here there is a lack of trees, giving a view of the stars. In the center of the clearing, there is an oddly symmetrical pond. You can see that the trees on the perimeter of the surrounding fields are very similar, but don't quite mirror each other. 

 You can see two paths on either side of the clearing. West is Western Field, and East is Eastern Field. You can see the cabin up ahead. North is to the cabin's front door. The path South leads to the Campsite.

>enter pond
You get onto the Pond.

>fill canteen
You filled the canteen with the pond water.
The canteen is full.

* * *

>s
(first getting off the Pond)

Campsite
The campsite is surrounded with greenery. In the center of the camp is a roaring fire. Luigi is lounging around the campsite. He seems to be carrying some kind of flat, wooden object. You should try talking to him first. 

 Your pitched tent is South. North is the Forest Clearing.

>give canteen to luigi
Luigi: Yo, thanks! Here's the board, as promised. I forgot to mention that I don't know how to open the board. It's like it's magically shut!  No matter what I do, I can't seem to get it open. Maybe you have some idea of how to do it?

 You are now carrying the Ouija Board.

>knock 3 times on ouija board
You hear a click. The ouija board can now be opened.

>open ouija board
You open the board as you would a book, and see that the inside is intact. It looks like the traditional Ouija Board, with the alphabet, numbers 0-9, "Yes" and "No" at the two top corners of the board. The planchette is fixed to the board in a way so that keeps it from falling off the board when used. Below the numbes, you read "GOOD BYE" in large letters. In the bottom hand corner of the board you read "Property of xxxx xxxxxxxx, Paranormal Investigator". 

 Luigi quietly comes up from behind you. 

 Luigi: YO! Heh, scared you didn't I? You jumped about six feet. Oh, you got the board open! I guess I'll follow you around now that things are getting interesting.Try asking the board about the spirit.

 Luigi is now following you.

>eat steak pie
You can't see any such thing.

>take crispy duck
You can't see any such thing.

* * *

>l
Campsite
The campsite is surrounded with greenery. In the center of the camp is a roaring fire. Luigi is lounging around the campsite. He seems to be carrying some kind of flat, wooden object. You should try talking to him first. 

 Your pitched tent is South. North is the Forest Clearing.

* * *

>x campfire
A blazing campfire to keep you and Luigi warm.

>take campfire
That's hardly portable.

>talk to luigi
Luigi: Yo! Feel free to ask me about stuff. 

 You can ask Luigi about Tent, Campsite, Board, Himself, Yourself, etc.

>ask luigi about tent
Luigi: There's some stuff in the tent that we brought. Some tools and survival essentials.

* * *

>open ouija board
Luigi is carrying the Ouija Board, so you can't open it.

>open ouija board
Luigi is carrying the Ouija Board, so you can't open it.

>s
Tent
Your backpack sits in the corner. The sleeping bags are unrolled on the ground.

 North is the Campsite.

>open backpack
You open the Backpack, revealing a Canteen.

* * *

>take canteen
Taken.

>n
Campsite
The campsite is surrounded with greenery. In the center of the campsite a roaring camfire blazes. Luigi is lounging around the campsite. He seems to be carrying some kind of flat, wooden object. You should try talking to him first. 

 Your pitched tent is South. North is the Forest Clearing.

>n
Forest Clearing
Here there is a lack of trees, giving a view of the stars. In the center of the clearing, there is an oddly symmetrical pond. Now that you look around, you realize that the trees on the perimeter of the surrounding fields are very similar, but don't quite mirror each other. 

 You can see two paths on either side of the clearing. West is Western Field, and East is Eastern Field. You can see a cabin up ahead. North is to the cabin's front door. The path South leads to the Campsite.

>fill canteen
You can only fill the canteen with water. And, you have to be in water to fill it.

>enter pond
You get onto the Pond.

* * *

>take board
You can't just take the board from Luigi.

>take ouija board
You can't just take the board from Luigi.

* * *

I beg your pardon?

>ask board about murders
There is no reply.

>ask board about spirit
There is no reply.

>s
Tent
Your backpack sits in the corner. The sleeping bags are unrolled on the ground.

 North is the Campsite.

* * *

>n
Forest Clearing
Here there is a lack of trees, giving a view of the stars. In the center of the clearing, there is an oddly symmetrical pond. Now that you look around, you realize that the trees on the perimeter of the surrounding fields are very similar, but don't quite mirror each other. 

 You can see two paths on either side of the clearing. West is Western Field, and East is Eastern Field. You can see a cabin up ahead. North is to the cabin's front door. The path South leads to the Campsite.

>enter pond
You get onto the Pond.

>fill canteen
You filled the canteen with the pond water.

>fill canteen with water
I only understood you as far as wanting to fill the Canteen.

>fill canteen
The canteen is already full.

>fill canteen with water
I only understood you as far as wanting to fill the Canteen.

>s
(first getting off the Pond)

Campsite
The campsite is surrounded with greenery. In the center of the campsite a roaring camfire blazes. Luigi is lounging around the campsite. He seems to be carrying some kind of flat, wooden object. You should try talking to him first. 

 Your pitched tent is South. North is the Forest Clearing.

* * *

>ive canteen
That's not a verb I recognise.

>give canteen
(to Luigi)
Luigi: Yo, thanks! Here's the board, as promised. I forgot to mention that I don't know how to open the board. It's like it's magically shut!  No matter what I do, I can't seem to get it open. Maybe you have some idea of how to do it?

 You are now carrying the Ouija Board.

* * *

>knock 3 times on board
You hear a click. The ouija board is now openable.

>open ouija board
You open the board as you would a book, and see that the inside is intact. It looks like the traditional Ouija Board, with the alphabet, numbers 0-9, "Yes" and "No" at the two top corners of the board. The planchette is fixed to the board in a way so that keeps it from falling off the board when used. Below the numbes, you read "GOOD BYE" in large letters. In the bottom hand corner of the board you read "Property of xxxx xxxxxxxx, Paranormal Investigator". 

 You notice that Luigi comes up from behind you. 

 Luigi: Yo! You got the board open. Try asking the board about the spirit.

>open ouija board
You open the board as you would a book, and see that the inside is intact. It looks like the traditional Ouija Board, with the alphabet, numbers 0-9, "Yes" and "No" at the two top corners of the board. The planchette is fixed to the board in a way so that keeps it from falling off the board when used. Below the numbes, you read "GOOD BYE" in large letters. In the bottom hand corner of the board you read "Property of xxxx xxxxxxxx, Paranormal Investigator". 

 You notice that Luigi comes up from behind you. 

 Luigi: Yo! You got the board open. Try asking the board about the spirit.

>drop ouija board
Dropped.

>open ouija board
Like Luigi said, the board seems to be stuck shut like magic. Maybe you can find a way to open it?

* * *

>talk to luigi
Luigi: Yo! Feel free to ask me about stuff. 

 You can ask Luigi about Tent, Campsite, Object, Himself, Yourself, etc.

>ask luigi about object
Luigi: It's a ouija board! Hey, I'll let you take a look at it if you get me something to drink. I'm a bit parched. 

 You can ask Luigi about Ouija Board, Tent, Campsite, Himself, Yourself, etc.

>ask luigi
What do you want to ask Luigi for?

>ask
What do you want to ask Luigi for?

>n
You must name something more substantial.

>ask
What do you want to ask Luigi for?

* * *

>n
You must name something more substantial.

>n
Forest Clearing
Here there is a lack of trees, giving a view of the stars. In the center of the clearing, there is an oddly symmetrical pond. You can see that the trees on the perimeter of the surrounding fields are very similar, but don't quite mirror each other. 

 You can see two paths on either side of the clearing. West is Western Field, and East is Eastern Field. You can see the cabin up ahead. North is to the cabin's front door. The path South leads to the Campsite.

>ask
What do you want to ask yourself for?

>ask
What do you want to ask yourself for?

>ask about
You can't see any such thing.

>ask about pie
You can't see any such thing.

>ask about board
You can't see any such thing.

>s
Campsite
The campsite is surrounded with greenery. In the center of the camp is a roaring fire. Luigi is lounging around the campsite. He seems to be carrying some kind of flat, wooden object. You should try talking to him first. 

 Your pitched tent is South. North is the Forest Clearing.

>ask about board
You can't see any such thing.

>ask about tent
You can't see any such thing.

>ask luigi about tent
Luigi: There's some stuff in the tent that we brought. Some survival essentials, you know, like our blanky? Haha, just kidding around. Go see for yourself.

>x tent
You can't see any such thing.

>n
Forest Clearing
Here there is a lack of trees, giving a view of the stars. In the center of the clearing, there is an oddly symmetrical pond. You can see that the trees on the perimeter of the surrounding fields are very similar, but don't quite mirror each other. 

 You can see two paths on either side of the clearing. West is Western Field, and East is Eastern Field. You can see the cabin up ahead. North is to the cabin's front door. The path South leads to the Campsite.

>n
You need to be focusing on getting Luigi something to drink! You can come back to the cabin after.

>inventory
You are carrying nothing.

>s
Campsite
The campsite is surrounded with greenery. In the center of the camp is a roaring fire. Luigi is lounging around the campsite. He seems to be carrying some kind of flat, wooden object. You should try talking to him first. 

 Your pitched tent is South. North is the Forest Clearing.

>n
Forest Clearing
Here there is a lack of trees, giving a view of the stars. In the center of the clearing, there is an oddly symmetrical pond. You can see that the trees on the perimeter of the surrounding fields are very similar, but don't quite mirror each other. 

 You can see two paths on either side of the clearing. West is Western Field, and East is Eastern Field. You can see the cabin up ahead. North is to the cabin's front door. The path South leads to the Campsite.

>modd of player
That's not a verb I recognise.

>mood of playr
That's not a verb I recognise.

>mood of player
That's not a verb I recognise.

>n
You need to be focusing on getting Luigi something to drink! You can come back to the cabin after.

>use ouijaboard
You can't see any such thing.

>use ouija board
You can't see any such thing.

>i
You are carrying nothing.

>s
Campsite
The campsite is surrounded with greenery. In the center of the camp is a roaring fire. Luigi is lounging around the campsite. He seems to be carrying some kind of flat, wooden object. You should try talking to him first. 

 Your pitched tent is South. North is the Forest Clearing.

* * *

>s
(first getting off the Pond)

Campsite
The campsite is surrounded with greenery. In the center of the camp is a roaring fire. Luigi is lounging around the campsite. He seems to be carrying some kind of flat, wooden object. You should try talking to him first. 

 Your pitched tent is South. North is the Forest Clearing.

>give canteen
(to Luigi)
Luigi: Yo, thanks! Here's the board, as promised. I forgot to mention that I don't know how to open the board. It's like it's magically shut!  No matter what I do, I can't seem to get it open. Maybe you have some idea of how to do it?

 You are now carrying the Ouija Board.

>n
Forest Clearing
Here there is a lack of trees, giving a view of the stars. In the center of the clearing, there is an oddly symmetrical pond. You can see that the trees on the perimeter of the surrounding fields are very similar, but don't quite mirror each other. 

 You can see two paths on either side of the clearing. West is Western Field, and East is Eastern Field. You can see the cabin up ahead. North is to the cabin's front door. The path South leads to the Campsite.

Luigi is with you.

>n
Cabin
 You enter the abandoned cabin.  The room has peeling walls and a rotten wooden floor. Both seem to be splattered with a dark stain. There is no furniture in the room, besides a single book lying in the middle of the floor. 

 North of this room is the Attic. East of here is an open door leading to what looks like a bedroom.  South is Forest Clearing.

Luigi is with you.

>knock 3 times on board
You hear a click. The ouija board can now be opened.

>open ouija board
You open the board as you would a book, and see that the inside is intact. It looks like the traditional Ouija Board, with the alphabet, numbers 0-9, "Yes" and "No" at the two top corners of the board. The planchette is fixed to the board in a way so that keeps it from falling off the board when used. Below the numbes, you read "GOOD BYE" in large letters. In the bottom hand corner of the board you read "Property of xxxx xxxxxxxx, Paranormal Investigator". 

 Luigi quietly comes up from behind you. 

 Luigi: YO! Heh, scared you didn't I? You jumped about six feet. Oh, you got the board open! I guess I'll follow you around now that things are getting interesting.Try asking the board about the spirit.

 Luigi is now following you.

>n
(first opening attic door)
It seems to be locked.

>n
(first opening attic door)
It seems to be locked.

>e
Bedroom
Besides a bed and a dresser, the room is barren. Like the first room in the cabin, it is covered in dust. 

West is the Cabin's entrance room.

Luigi is with you.

>take axe
Taken.

>take all
You can't use multiple objects with that verb.

>w
Cabin
 The room has peeling walls and a rotten wooden floor. Both seem to be splattered with a dark stain. There is no furniture in the room, besides a single book lying in the middle of the floor. 

 North of this room is the Attic. East of here is the Bedroom. South is Forest Clearing.

Luigi is with you.

>s
Forest Clearing
Here there is a lack of trees, giving a view of the stars. In the center of the clearing, there is an oddly symmetrical pond. You can see that the trees on the perimeter of the surrounding fields are very similar, but don't quite mirror each other. 

 You can see two paths on either side of the clearing. West is Western Field, and East is Eastern Field. You can see the cabin up ahead. North is to the cabin's front door. The path South leads to the Campsite.

Luigi is with you.

>e
Eastern Field
There is an interesting formation of trees on the far end of the field.

 West is Forest Clearing.

Luigi is with you.

>chop down tree
You chop down the oak tree with the axe, making a tree stump just like the one in the Western field. A mirror image was made. From inside the stump, you see a wooden key.

>take key
After taking the wooden key, you notice that the planchette begins to move on its own. It spells "You are brave... Now go..."

 For once, you really do feel brave. And even stranger, you feel inclinced to listen to the spirit.

>w
Forest Clearing
Here there is a lack of trees, giving a view of the stars. In the center of the clearing, there is an oddly symmetrical pond. You can see that the trees on the perimeter of the surrounding fields are very similar, but don't quite mirror each other.  However, after cutting down the oak tree, the trees on the perimeter of the surrounding fields create a mirror image.

 You can see two paths on either side of the clearing. West is Western Field, and East is Eastern Field. You can see the cabin up ahead. North is to the cabin's front door. The path South leads to the Campsite.

>n
Cabin
 The room has peeling walls and a rotten wooden floor. Both seem to be splattered with a dark stain. There is no furniture in the room, besides a single book lying in the middle of the floor. 

 North of this room is the Attic. East of here is the Bedroom. South is Forest Clearing.

>n
(first unlocking the attic door with the wooden key, then opening the door)

Attic
The Attic is dust covered and moldy. There is a single, round window overlooking the Creek.  In the center of the room, on the hard floor, is a skeleton. 

 South is the Cabin's entrance room.

>x name card
You read, "xxxx xxxxxxxx, Paranormal Investigator. 

 The planchette moves one final time. Your heart feels like it has stopped in your chest. The planchette spells "Prove your bravery and kill your friend. Or you will both die". You hear the attic door slam behind you.

 The skeletal remains of the Paranormal Investigator slowly animates, rising to its feet. It looks as if it is being possessed, no doubt by the spirit of the axe murderer. With startling ease, it begins to move towards you with murderous intent. You need to make a decision, and fast! For the first time, you notice a scrap of paper on the floor beside you. Picking it up, you read "Search the pond. There you will find the remains. You must burn the remains if you want to survive." Is this a dying message from the paranormal investigator?

 Luigi: What do we do?! You're not going to kill me, are you?! I say we chop down the skeleton!! Kill it before it kills us! 

You need to carefully (yet quickly) look at your surroundings and take note of your items. There is only one correct way out of this situation.

Luigi is with you.

>kill luigi
Even in your final attempt to prove your bravery, you cannot bring yourself to kill your friend. The skeleton (possessed by the spirit of the axe murderer) is upon you. You die a coward.

    *** BAD END. ***

Would you like to RESTART, RESTORE a saved game, QUIT or UNDO the last command?

>undo
Attic
[Previous turn undone.]

>axe floor
You can't see any such thing.

>cut floor
You can't see any such thing.

>cut attic floor
You can't see any such thing.

>chop down attic floor
You can't see any such thing.

>l
Attic
The Attic is dust covered and moldy. There is a single, round window overlooking the Creek. The possessed skeleton monster is slowly but surely making its way towards you from the center of the room. Time is running out. 

 South is the Cabin's entrance room.

>axe door
With two quick swipes of your axe, you break down the attic door. You drop the axe, and run out of the cabin, into the forest clearing. You have made the brave, but intelligent decision. Now, you must save yourself and Luigi from the spirit of the axe murderer that possesses the skeleton of the paranormal investigator. Follow the investigator's instructions carefully, time is of the essence. You can hear the skeleton racing down the attic.

Forest Clearing
Here there is a lack of trees, giving a view of the stars. In the center of the clearing, there is an oddly symmetrical pond. You can see that the trees on the perimeter of the surrounding fields are very similar, but don't quite mirror each other. 

 You can see two paths on either side of the clearing. West is Western Field, and East is Eastern Field. You can see the cabin up ahead. North is to the cabin's front door. The path South leads to the Campsite.

Luigi is with you.

>axe door
You can't see any such thing.

>n
It's not a good idea to go back there. The axe murderer is coming.

>s
Campsite
The campsite is surrounded with greenery. In the center of the camp is a roaring fire.

 Your pitched tent is South. North is the Forest Clearing.

Luigi is with you.

>n
Forest Clearing
Here there is a lack of trees, giving a view of the stars. In the center of the clearing, there is an oddly symmetrical pond. You can see that the trees on the perimeter of the surrounding fields are very similar, but don't quite mirror each other. 

 You can see two paths on either side of the clearing. West is Western Field, and East is Eastern Field. You can see the cabin up ahead. North is to the cabin's front door. The path South leads to the Campsite.

The sounds of the approaching skeleton are getting louder. Hurry!

Luigi is with you.

>inventory
You are carrying:
  Paper
  Wooden Key
  ouija board

The sounds of the approaching skeleton are getting louder. Hurry!

>n
It's not a good idea to go back there. The axe murderer is coming.

>enter pond
You get onto the Pond.

>search pond
You follow the instructions on the piece of paper, and after digging around the pond, you see a large skull sunken beneath the surface.

>take skull
Taken.

The sounds of the approaching skeleton are getting louder. Hurry!

>s
(first getting off the Pond)

Campsite
The campsite is surrounded with greenery. In the center of the camp is a roaring fire.

 Your pitched tent is South. North is the Forest Clearing.

Luigi is with you.

>n
Forest Clearing
Here there is a lack of trees, giving a view of the stars. In the center of the clearing, there is an oddly symmetrical pond. You can see that the trees on the perimeter of the surrounding fields are very similar, but don't quite mirror each other. 

 You can see two paths on either side of the clearing. West is Western Field, and East is Eastern Field. You can see the cabin up ahead. North is to the cabin's front door. The path South leads to the Campsite.

The sounds of the approaching skeleton are getting louder. Hurry!

Luigi is with you.

>destroy skull
You are no where near a fire.

>yes
That was a rhetorical question.

>n
It's not a good idea to go back there. The axe murderer is coming.

* * *

>s
Campsite
The campsite is surrounded with greenery. In the center of the camp is a roaring fire.

 Your pitched tent is South. North is the Forest Clearing.

Luigi is with you.

>burn skull
As you near the flames, you feel a growing nervousness and fear of the outcome. The planchette angrily moves rapidly from each of the corners of the board. The skeleton is almost upon you. Are you sure?

>yes
You finally bring yourself to push away your fears, and throw the skull into the fire. The skeleton falls to pieces, and the planchette lays frozen on the board.

 Luigi: You did it... You saved us! I guess I have to admit you're not some big scaredy-cat after all.

    *** GOOD END. ***

Would you like to RESTART, RESTORE a saved game, QUIT or UNDO the last command?

* * *

>talk to luigi
Luigi: Yo! Feel free to ask me about stuff. 

 You can ask Luigi about Tent, Campsite, Object, Himself, Yourself, etc.

>talk to luigi
Luigi: Yo! Feel free to ask me about stuff. 

 You can ask Luigi about Tent, Campsite, Board, Himself, Yourself, etc.

>ask luigi about board
Luigi: It's a ouija board! Hey, I'll let you take a look at it if you get me something to drink. I'm a bit parched. 

 You can ask Luigi about Ouija Board, Tent, Campsite, Himself, Yourself, etc.

>x ouija board
What seems to be an old fashioned Ouija board in Luigi's possession.

>take ouija board
You can't just take the board from Luigi.

>s
Tent
Your backpack sits in the corner. The sleeping bags are unrolled on the ground.

 North is the Campsite.

* * *

>fill canteen
You filled the canteen with the pond water.
The canteen is full.

>s
(first getting off the Pond)

Campsite
The campsite is surrounded with greenery. In the center of the campsite a roaring camfire blazes. Luigi is lounging around the campsite. He seems to be carrying some kind of flat, wooden object. You should try talking to him first. 

 Your pitched tent is South. North is the Forest Clearing.

>give canteen to luigi
Luigi: Yo, thanks! Here's the board, as promised. I forgot to mention that I don't know how to open the board. It's like it's magically shut!  No matter what I do, I can't seem to get it open. Maybe you have some idea of how to do it?

 You are now carrying the Ouija Board.

>n
Forest Clearing
Here there is a lack of trees, giving a view of the stars. In the center of the clearing, there is an oddly symmetrical pond. Now that you look around, you realize that the trees on the perimeter of the surrounding fields are very similar, but don't quite mirror each other. 

 You can see two paths on either side of the clearing. West is Western Field, and East is Eastern Field. You can see a cabin up ahead. North is to the cabin's front door. The path South leads to the Campsite.

>n
Cabin
 You enter the abandoned cabin.  The room has peeling walls and a rotten wooden floor. Both seem to be splattered with a dark stain. There is no furniture in the room, besides a single book lying in the middle of the floor. 

 North of this room is the Attic. East of here is an open door leading to what looks like a bedroom.  South is Forest Clearing.

>e
Bedroom
Besides a bed and a dresser, the room is barren. Like the first room in the cabin, it is covered in dust. 

West is the Cabin's entrance room.

>take axe
Taken.

>e
You can't go that way.

>w
Cabin
 The room has peeling walls and a rotten wooden floor. Both seem to be splattered with a dark stain. There is no furniture in the room, besides a single book lying in the middle of the floor. 

 North of this room is the Attic. East of here is the Bedroom. South is Forest Clearing.

>n
(first opening attic door)
It seems to be locked.

>s
Forest Clearing
Here there is a lack of trees, giving a view of the stars. In the center of the clearing, there is an oddly symmetrical pond. Now that you look around, you realize that the trees on the perimeter of the surrounding fields are very similar, but don't quite mirror each other. 

 You can see two paths on either side of the clearing. West is Western Field, and East is Eastern Field. You can see a cabin up ahead. North is to the cabin's front door. The path South leads to the Campsite.

>w
Western Field
There is an interesting formation of trees on the far end of the field.

 East is Forest Clearing.

>chop down oak tree
You can't see any such thing.

>x trees
You see five identical birch trees (name: Western Birch Trees), all growing in a straight row. On one end of the row of trees, there is a tree stump.

>w
You can't go that way.

>e
Forest Clearing
Here there is a lack of trees, giving a view of the stars. In the center of the clearing, there is an oddly symmetrical pond. Now that you look around, you realize that the trees on the perimeter of the surrounding fields are very similar, but don't quite mirror each other. 

 You can see two paths on either side of the clearing. West is Western Field, and East is Eastern Field. You can see a cabin up ahead. North is to the cabin's front door. The path South leads to the Campsite.

>e
Eastern Field
There is an interesting formation of trees on the far end of the field.

 West is Forest Clearing.

>chop down oak tree
You chop down the oak tree with the axe, making a tree stump just like the one in the Western field. A mirror image was made. From inside the stump, you see a wooden key.

>take wooden key
After taking the wooden key, you notice that the planchette begins to move on its own. It spells "You are brave... Now go..."

>w
Forest Clearing
Here there is a lack of trees, giving a view of the stars. In the center of the clearing, there is an oddly symmetrical pond. Now that you look around, you realize that the trees on the perimeter of the surrounding fields are very similar, but don't quite mirror each other. 

 You can see two paths on either side of the clearing. West is Western Field, and East is Eastern Field. You can see a cabin up ahead. North is to the cabin's front door. The path South leads to the Campsite.

>n
Cabin
 The room has peeling walls and a rotten wooden floor. Both seem to be splattered with a dark stain. There is no furniture in the room, besides a single book lying in the middle of the floor. 

 North of this room is the Attic. East of here is the Bedroom. South is Forest Clearing.

>n
(first unlocking the attic door with the wooden key, then opening the door)

Attic
The Attic is dust covered and moldy. There is a single, round window overlooking the Creek.  In the center of the room, on the floor, is a skeleton. 

 South is the Cabin's entrance room.

>s
Cabin
 The room has peeling walls and a rotten wooden floor. Both seem to be splattered with a dark stain. There is no furniture in the room, besides a single book lying in the middle of the floor. 

 North of this room is  a door that must lead to the Attic. East of here is the Bedroom. South is Forest Clearing.

I beg your pardon?

>n
Attic
The Attic is dust covered and moldy. There is a single, round window overlooking the Creek.  In the center of the room, on the floor, is a skeleton. 

 South is the Cabin's entrance room.

>s
Cabin
 The room has peeling walls and a rotten wooden floor. Both seem to be splattered with a dark stain. There is no furniture in the room, besides a single book lying in the middle of the floor. 

 North of this room is  a door that must lead to the Attic. East of here is the Bedroom. South is Forest Clearing.

>n
Attic
The Attic is dust covered and moldy. There is a single, round window overlooking the Creek.  In the center of the room, on the floor, is a skeleton. 

 South is the Cabin's entrance room.

>x name card
You read, "xxxx xxxxxxxx, Paranormal Investigator. 

 The planchette moves one final time. Your heart feels like it has stopped when the planchette spells "You're next". You hear the attic door slam behind you.

 The skeletal remains of the Paranormal Investigator slowly animates, rising to its feet. It looks as if it is being possessed, no doubt by the spirit of the axe murderer. With startling ease, it begins to move towards you with murderous intent. You need to escape the Attic, and fast!

 Luigi: What do we do?! I say we chop down the skeleton!! Kill it before it kills us! 

You need to carefully (yet quickly) look at your surroundings and take note of your items. Figure out the best way out of this situation.

>s
The door is jammed, seemingly by some unknown force. The wooden key no longer works.

>unlock attic door
What do you want to unlock attic door with?

>unlock attic door with wooden key
The wooden key no longer works.

>l
Attic
The Attic is dust covered and moldy. There is a single, round window overlooking the Creek. The possessed skeleton monster is slowly but surely making its way towards you from the center of the room. Time is running out. 

 South is the Cabin's entrance room.

>x
What do you want to examine?

>x attic
(attic door)
You see nothing special about attic door.

>jump out of window
Not knowing how to escape the monster, you and Luigi jump out of the attic window. However, the distance to the ground is too great, and you both fall to your deaths.

    *** BAD END. ***

Would you like to RESTART, RESTORE a saved game, QUIT or UNDO the last command?

* * *

>talk to luigi
Luigi: Yo! Feel free to ask me about stuff. 

 You can ask Luigi about Tent, Campsite, Object, Himself, Yourself, etc.

>ask luigi about tent
Luigi: There's some stuff in the tent that we brought. Some survival essentials, you know, like our blanky? Haha, just kidding around. Go see for yourself.

>ask luigi about campsite
Luigi: They say this whole area is haunted. I heard there were even series of murders commited in that cabin up north. 

 You can ask Luigi about Murders, Tent, object, Himself, Cabin, Yourself, etc.

* * *

>ask luigi about murders
Luigi: Most of the stories weren't disclosed to the public, but I heard they were all  axe murders.  Haha, sorry, I know you get freaked out pretty easily. Don't worry, though, all the murders happened a really long time ago. The killer's long dead by now, though some people say that his spirit haunts this creek to this day. That's why this place is called Axe Creek.

 You can ask Luigi about Tent, object, Himself, Cabin, Yourself, etc..

>ask luigi about object
Luigi: It's a ouija board! Hey, I'll let you take a look at it if you get me something to drink. I'm a bit parched. 

 You can ask Luigi about Ouija Board, Tent, Campsite, Himself, Yourself, etc.

* * *

>ask luigi about ouija board
Luigi: They're so cool! I found this one buried in the dirt while I was nailing the tent into the ground. I guess I was meant to find it! Hm, maybe I'll let you take a look at it if you get me something to drink.

>ask luigi about himself
Luigi: I love camping! All this fun is making me a bit thirsty, though. Maybe you can get me something to drink?

* * *

>ask luigi about yourself
Luigi: I can't believe you had the guts to come camping out here! You're definitely not the bravest person I've ever met.

>n
Forest Clearing
Here there is a lack of trees, giving a view of the stars. In the center of the clearing, there is an oddly symmetrical pond. Now that you look around, you realize that the trees on the perimeter of the surrounding fields are very similar, but don't quite mirror each other.

 You can see two paths on either side of the clearing. West is Western Field, and East is Eastern Field. You can see the cabin up ahead. North is to the cabin's front door. The path South leads to the Campsite.

>w
Western Field
There is an interesting formation of trees on the far end of the field.

 East is Forest Clearing.

>x trees
You see five identical birch trees (name: Western Birch Trees), all growing in a straight row. On one end of the row of trees, there is a tree stump.

* * *

>x stump
It looks like it was cut clean with an axe. From looking at the wood, you assume the stump used to be an oak tree.

>take stump
That's hardly portable.

>take trees
That's hardly portable.

>e
Forest Clearing
Here there is a lack of trees, giving a view of the stars. In the center of the clearing, there is an oddly symmetrical pond. Now that you look around, you realize that the trees on the perimeter of the surrounding fields are very similar, but don't quite mirror each other.

 You can see two paths on either side of the clearing. West is Western Field, and East is Eastern Field. You can see the cabin up ahead. North is to the cabin's front door. The path South leads to the Campsite.

>w
Western Field
There is an interesting formation of trees on the far end of the field.

 East is Forest Clearing.

* * *

>x trees
You see five identical birch trees (name: Western Birch Trees), all growing in a straight row. On one end of the row of trees, there is a tree stump.

>e
Forest Clearing
Here there is a lack of trees, giving a view of the stars. In the center of the clearing, there is an oddly symmetrical pond. Now that you look around, you realize that the trees on the perimeter of the surrounding fields are very similar, but don't quite mirror each other.

 You can see two paths on either side of the clearing. West is Western Field, and East is Eastern Field. You can see the cabin up ahead. North is to the cabin's front door. The path South leads to the Campsite.

>e
Eastern Field
There is an interesting formation of trees on the far end of the field.

 West is Forest Clearing.

>x trees
You see five identical birch trees (name: Eastern Birch Trees), all growing in a straight row. On one end of the row of trees, there is an oak tree, where, in the Western Field, there is a stump.

* * *

>x oak tree
The tall oak tree looks out of place in the Eastern Field.

>kill oak tree
You have nothing to cut it down with.

>w
Forest Clearing
Here there is a lack of trees, giving a view of the stars. In the center of the clearing, there is an oddly symmetrical pond. Now that you look around, you realize that the trees on the perimeter of the surrounding fields are very similar, but don't quite mirror each other.

 You can see two paths on either side of the clearing. West is Western Field, and East is Eastern Field. You can see the cabin up ahead. North is to the cabin's front door. The path South leads to the Campsite.

>n
Cabin
 You enter the abandoned cabin.  The room has peeling walls and a rotten wooden floor. Both seem to be splattered with a dark stain. There is no furniture in the room, besides a single book lying in the middle of the floor. 

 North of this room is the Attic. East of here is an open door leading to what looks like a bedroom.  South is Forest Clearing.

>x stain
It's hard to tell what the source of the dark stains was. They were definitely made some time ago, though.

>x room
You can't see any such thing.

>x walls
The barren walls are nothing but moldy and peeling. The stains covering are peculiar in the way that they seemed to have been splattered across the walls.

>x floor
The wood is so rotten that you're afraid the structure might break under your weight. The stains are peculiar in the way that they seemed to have been splattered across the floor.

>x book
An odd, worn book. The cover reads:  Beware of Ouija.  There seems to be four pages in the Ouija Book, though many of the words are smudged and indecipherable. Start by reading page 1 of Ouija Book.

>read page one of ouija book
You're not reading anything.

>read book
You need to pick up the book first.

>take book
Taken.

>read page 1 of book
You read: " Entry One of Four. xx/xx/xxxx.  I am writing this diary to record my investigations of the axe murder house, located in this very forest in xxxxxxx. I am the famous paranormal invesitgator, xxxx xxxxxxxx. I have come here with the intentions of contacting the spirit of the axe murderer, xxxxxxxx xxx, who died in these woods xx years ago. Reasons behind these murders as well as facts on the killer are unknown. To uncover these mysteries, I plan to contact the spirit of the murderer himself using my ouija board. Also known as the Witch Board, the Ouija Board is an ancient tool used to form a connection with the departed, first used by the Chinese in 1100 AD. Tomorrow night, here in the cabin, I will attempt to make spiritual contact through the board."

>read next page
(in ouija book)
You read: " Entry Two of Four. xx/xx/xxxx.  Night has fallen, and I am ready to open the board and begin communication with xxxxxxxx xxx. I am quite proud of my special Ouija board. It is unique in that you must knock three times on the board to open it. This insures that not just anyone can have easy access to the board, as using a ouija board is quite dangerous. After opening the board, I will place my hands on the planchette and ready myself both mentally and physically to encounter xxxxxxxx xxx's malevolent spirit. Anyone who's used a ouija board before knows that if the planchette moves to each of the four corners of the board, you have contacted an evil spirit. So, that's what I'm keeping an eye out for while I'm searching for the axe murderer's spirit."

>read next page
(in ouija book)
You read: " Entry Three of Four. xx/xx/xxxx.  I did it-- I reached the spirit of xxxxxxxx xxx. His spirit is unlike any I have come into contact with. It responds much faster, and with much greater intelligence than those of most entities. It is powerful, that much is apparent. I must remain wary of xxxxxxxx xxx's malicious intent; false flattery and lies are only to be expected from the likes of it. If anything begins to go wrong, I will simply exit the conversation by moving the planchette to the part of the board "GOOD BYE", which should sever the connection between the spirit and myself. Let this be a reminder to myself and a warning to anyone reading this:  If the spirit should somehow possess an object/body, do NOT ATTEMPT TO KILL IT. This will only result in eminent death. Evil spirits are not to be reckoned with. My goal is to inquire about the final resting place of xxxxxxxx xxx, find the remains, and burn them. Hopefully, by doing this, the spirit will be put to rest."

>read next page
(in ouija book)
You read: " Final Entry. xx/xx/xxxx.  N o ! This cannot be happening! I have lost control of the planchette, and am unable to exit through the normal means of "GOODBYE". I was a fool. I was nave. The spirit was too cunning. I am frant cally writing t is to anyo e who fi s my d ary or my ouija b ard. D o not fall vic im to the spir t! It wil turn y u agai st your friends. Be Brave.  And wha ever yo u do, do not destroy t e  o ija boa d!!!!"

>read next page
(in ouija book)
There are only four pages in the book.

>e
Bedroom
Besides a bed and a dresser, the room is barren. Like the first room in the cabin, it is covered in dust. 

West is the Cabin's entrance room.

>x dresser
Even when covered with a thick coat of dust, you can see the outline of a single drawer.

>open drawer
You open the drawer to reveal an old, rusted axe. On the inside of the drawer there are dark brown stains on the wood as well as on the axe blade.

>x drawer
Even when covered with a thick coat of dust, you can see the outline of a single drawer.

>take axe
Taken.

>w
Cabin
 The room has peeling walls and a rotten wooden floor. Both seem to be splattered with a dark stain. There is no furniture in the room. 

 North of this room is the Attic. East of here is the Bedroom. South is Forest Clearing.

>n
(first opening attic door)
It seems to be locked.

* * *

>n
Forest Clearing
Here there is a lack of trees, giving a view of the stars. In the center of the clearing, there is an oddly symmetrical pond. Now that you look around, you realize that the trees on the perimeter of the surrounding fields are very similar, but don't quite mirror each other.

 You can see two paths on either side of the clearing. West is Western Field, and East is Eastern Field. You can see the cabin up ahead. North is to the cabin's front door. The path South leads to the Campsite.

>fill canteen
You can only fill the canteen with water. And, you have to be in water to fill it.

* * *

>enter pond
You get onto the Pond.

>enter water
That's not something you can enter.

>fill canteen
You filled the canteen with the pond water.
The canteen is full.

* * *

>give canteen to luigi
Luigi: Yo, thanks! Here's the board, as promised. I forgot to mention that I don't know how to open the board. It's like it's magically shut!  No matter what I do, I can't seem to get it open. Maybe you have some idea of how to do it?

 You are now carrying the Ouija Board.

>open ouija board
Like Luigi said, the Board is closed shut like magic. Maybe you can find a way to open it.

>knock on board 3 times
You hear a click. The ouija board is now openable.

>open ouija book
It isn't something you can open.

>open ouija board
You open the board as you would a book, and see that the inside is intact. It looks like the traditional Ouija Board, with the alphabet, numbers 0-9, "Yes" and "No" at the two top corners of the board. The planchette is fixed to the board in a way so that keeps it from falling off the board when used. Below the numbes, you read "GOOD BYE" in large letters. In the bottom hand corner of the board you read "Property of xxxx xxxxxxxx, Paranormal Investigator". 

 Luigi quietly comes up from behind you. 

 Luigi: YO! Heh, scared you didn't I? You jumped about six feet. Oh, you got the board open! I guess I'll follow you around now that things are getting interesting.Try asking the board about the spirit.

 Luigi is now following you.

>open board
You open the board as you would a book, and see that the inside is intact. It looks like the traditional Ouija Board, with the alphabet, numbers 0-9, "Yes" and "No" at the two top corners of the board. The planchette is fixed to the board in a way so that keeps it from falling off the board when used. Below the numbes, you read "GOOD BYE" in large letters. In the bottom hand corner of the board you read "Property of xxxx xxxxxxxx, Paranormal Investigator". 

 Luigi quietly comes up from behind you. 

 Luigi: YO! Heh, scared you didn't I? You jumped about six feet. Oh, you got the board open! I guess I'll follow you around now that things are getting interesting.Try asking the board about the spirit.

 Luigi is now following you.

* * *

>talk luigi
I didn't understand that sentence.

>talk to luigi
Luigi: Yo! Feel free to ask me about stuff. 

 You can ask Luigi about Tent, Campsite, Board, Himself, Yourself, etc.

>tent
That's not a verb I recognise.

>ask about tent
You can't see any such thing.

>ask tent
You can't see any such thing.

>north
Forest Clearing
Here there is a lack of trees, giving a view of the stars. In the center of the clearing, there is an oddly symmetrical pond. Now that you look around, you realize that the trees on the perimeter of the surrounding fields are very similar, but don't quite mirror each other.

 You can see two paths on either side of the clearing. West is Western Field, and East is Eastern Field. You can see the cabin up ahead. North is to the cabin's front door. The path South leads to the Campsite.

>south
Campsite
The campsite is surrounded with greenery. In the center of the camp is a roaring fire. Luigi is lounging around the campsite. He seems to be carrying some kind of flat, wooden object. You should try talking to him first. 

 Your pitched tent is South. North is the Forest Clearing.

>talk to luigi
Luigi: Yo! Feel free to ask me about stuff. 

 You can ask Luigi about Tent, Campsite, Board, Himself, Yourself, etc.

>ask about ten
You can't see any such thing.

>ak about tent
That's not a verb I recognise.

>ask luigi about tent
Luigi: There's some stuff in the tent that we brought. Some survival essentials, you know, like our blanky? Haha, just kidding around. Go see for yourself.

>south
Tent
Your backpack sits in the corner. The sleeping bags are unrolled on the ground.

 North is the Campsite.

>observe
That's not a verb I recognise.

>sleep
What do you want to sleep in?

>sleeping bags
You're not very tired.

>north
Campsite
The campsite is surrounded with greenery. In the center of the camp is a roaring fire. Luigi is lounging around the campsite. He seems to be carrying some kind of flat, wooden object. You should try talking to him first. 

 Your pitched tent is South. North is the Forest Clearing.

>talk to luigi
Luigi: Yo! Feel free to ask me about stuff. 

 You can ask Luigi about Tent, Campsite, Board, Himself, Yourself, etc.

>ask luigi about himself
Luigi: I love camping! All this fun is making me a bit thirsty, though. Maybe you can get me something to drink?

>north
Forest Clearing
Here there is a lack of trees, giving a view of the stars. In the center of the clearing, there is an oddly symmetrical pond. Now that you look around, you realize that the trees on the perimeter of the surrounding fields are very similar, but don't quite mirror each other.

 You can see two paths on either side of the clearing. West is Western Field, and East is Eastern Field. You can see the cabin up ahead. North is to the cabin's front door. The path South leads to the Campsite.

>n
Cabin
 You enter the abandoned cabin.  The room has peeling walls and a rotten wooden floor. Both seem to be splattered with a dark stain. There is no furniture in the room, besides a single book lying in the middle of the floor. 

 North of this room is the Attic. East of here is an open door leading to what looks like a bedroom.  South is Forest Clearing.

>examine book
An odd, worn book. The cover reads:  Beware of Ouija.  There seems to be four pages in the Ouija Book, though many of the words are smudged and indecipherable. Start by reading page 1 of Ouija Book.

>read page
You can't see any such thing.

>read page 1
(in attic door)
There are no pages in attic door.

>read page 1 of oija book
You can't see any such thing.

>read page 1 of ouija book
You're not reading anything.

>pick up book
Taken.

>read page 1 of ouija book
You read: " Entry One of Four. xx/xx/xxxx.  I am writing this diary to record my investigations of the axe murder house, located in this very forest in xxxxxxx. I am the famous paranormal invesitgator, xxxx xxxxxxxx. I have come here with the intentions of contacting the spirit of the axe murderer, xxxxxxxx xxx, who died in these woods xx years ago. Reasons behind these murders as well as facts on the killer are unknown. To uncover these mysteries, I plan to contact the spirit of the murderer himself using my ouija board. Also known as the Witch Board, the Ouija Board is an ancient tool used to form a connection with the departed, first used by the Chinese in 1100 AD. Tomorrow night, here in the cabin, I will attempt to make spiritual contact through the board."

>read page 2 of ouija book
You read: " Entry Two of Four. xx/xx/xxxx.  Night has fallen, and I am ready to open the board and begin communication with xxxxxxxx xxx. I am quite proud of my special Ouija board. It is unique in that you must knock three times on the board to open it. This insures that not just anyone can have easy access to the board, as using a ouija board is quite dangerous. After opening the board, I will place my hands on the planchette and ready myself both mentally and physically to encounter xxxxxxxx xxx's malevolent spirit. Anyone who's used a ouija board before knows that if the planchette moves to each of the four corners of the board, you have contacted an evil spirit. So, that's what I'm keeping an eye out for while I'm searching for the axe murderer's spirit."

>read next page
(in ouija book)
You read: " Entry Three of Four. xx/xx/xxxx.  I did it-- I reached the spirit of xxxxxxxx xxx. His spirit is unlike any I have come into contact with. It responds much faster, and with much greater intelligence than those of most entities. It is powerful, that much is apparent. I must remain wary of xxxxxxxx xxx's malicious intent; false flattery and lies are only to be expected from the likes of it. If anything begins to go wrong, I will simply exit the conversation by moving the planchette to the part of the board "GOOD BYE", which should sever the connection between the spirit and myself. Let this be a reminder to myself and a warning to anyone reading this:  If the spirit should somehow possess an object/body, do NOT ATTEMPT TO KILL IT. This will only result in eminent death. Evil spirits are not to be reckoned with. My goal is to inquire about the final resting place of xxxxxxxx xxx, find the remains, and burn them. Hopefully, by doing this, the spirit will be put to rest."

* * *

>read next page
(in ouija book)
You read: " Final Entry. xx/xx/xxxx.  N o ! This cannot be happening! I have lost control of the planchette, and am unable to exit through the normal means of "GOODBYE". I was a fool. I was nave. The spirit was too cunning. I am frant cally writing t is to anyo e who fi s my d ary or my ouija b ard. D o not fall vic im to the spir t! It wil turn y u agai st your friends. Be Brave.  And wha ever yo u do, do not destroy t e  o ija boa d!!!!"

>south
Forest Clearing
Here there is a lack of trees, giving a view of the stars. In the center of the clearing, there is an oddly symmetrical pond. Now that you look around, you realize that the trees on the perimeter of the surrounding fields are very similar, but don't quite mirror each other.

 You can see two paths on either side of the clearing. West is Western Field, and East is Eastern Field. You can see the cabin up ahead. North is to the cabin's front door. The path South leads to the Campsite.

>w
Western Field
There is an interesting formation of trees on the far end of the field.

 East is Forest Clearing.

>examine trees
You see five identical birch trees (name: Western Birch Trees), all growing in a straight row. On one end of the row of trees, there is a tree stump.

>x stump
It looks like it was cut clean with an axe. From looking at the wood, you assume the stump used to be an oak tree.

>e
Forest Clearing
Here there is a lack of trees, giving a view of the stars. In the center of the clearing, there is an oddly symmetrical pond. Now that you look around, you realize that the trees on the perimeter of the surrounding fields are very similar, but don't quite mirror each other.

 You can see two paths on either side of the clearing. West is Western Field, and East is Eastern Field. You can see the cabin up ahead. North is to the cabin's front door. The path South leads to the Campsite.

* * *

>e
Eastern Field
There is an interesting formation of trees on the far end of the field.

 West is Forest Clearing.

>x tree
The tall oak tree looks out of place in the Eastern Field.

>x trees
You see five identical birch trees (name: Eastern Birch Trees), all growing in a straight row. On one end of the row of trees, there is an oak tree, where, in the Western Field, there is a stump.

>lick tree
That's not a verb I recognise.

>taste tree
You taste nothing unexpected.

>touch tree
You feel nothing unexpected.

>liste
That's not a verb I recognise.

>listen
You hear nothing unexpected.

>w
Forest Clearing
Here there is a lack of trees, giving a view of the stars. In the center of the clearing, there is an oddly symmetrical pond. Now that you look around, you realize that the trees on the perimeter of the surrounding fields are very similar, but don't quite mirror each other.

 You can see two paths on either side of the clearing. West is Western Field, and East is Eastern Field. You can see the cabin up ahead. North is to the cabin's front door. The path South leads to the Campsite.

>w
Western Field
There is an interesting formation of trees on the far end of the field.

 East is Forest Clearing.

>x stum
You can't see any such thing.

>x stump
It looks like it was cut clean with an axe. From looking at the wood, you assume the stump used to be an oak tree.

>touch stump
You feel nothing unexpected.

>w
You can't go that way.

>e
Forest Clearing
Here there is a lack of trees, giving a view of the stars. In the center of the clearing, there is an oddly symmetrical pond. Now that you look around, you realize that the trees on the perimeter of the surrounding fields are very similar, but don't quite mirror each other.

 You can see two paths on either side of the clearing. West is Western Field, and East is Eastern Field. You can see the cabin up ahead. North is to the cabin's front door. The path South leads to the Campsite.

>s
Campsite
The campsite is surrounded with greenery. In the center of the camp is a roaring fire. Luigi is lounging around the campsite. He seems to be carrying some kind of flat, wooden object. You should try talking to him first. 

 Your pitched tent is South. North is the Forest Clearing.

>talk to luigi
Luigi: Yo! Feel free to ask me about stuff. 

 You can ask Luigi about Tent, Campsite, Board, Himself, Yourself, etc.

>ask luigi about campsite
Luigi: They say this whole area is haunted. I heard there were even series of murders commited in that cabin up north. 

 You can ask Luigi about Murders, Tent, object, Himself, Cabin, Yourself, etc.

* * *

>ask luigi about ouija board
Luigi: They're so cool! I found this one buried in the dirt while I was nailing the tent into the ground. I guess I was meant to find it! Hm, maybe I'll let you take a look at it if you get me something to drink.

>s
Tent
Your backpack sits in the corner. The sleeping bags are unrolled on the ground.

 North is the Campsite.

* * *

>x backpack
Your small backpack containing your essentials for the weekend.

>take watr
You can't see any such thing.

>take water
You can't see any such thing.

>x essentials
You can't see any such thing.

>x sleeping bags
Some comfy sleeping bags.

>touch sleeping bags
You feel nothing unexpected.

>open backpack
You open the Backpack, revealing a Canteen.

* * *

>n
Campsite
The campsite is surrounded with greenery. In the center of the camp is a roaring fire. Luigi is lounging around the campsite. He seems to be carrying some kind of flat, wooden object. You should try talking to him first. 

 Your pitched tent is South. North is the Forest Clearing.

>talk to luigi
Luigi: Yo! Feel free to ask me about stuff. 

 You can ask Luigi about Tent, Campsite, Board, Himself, Yourself, etc.

* * *

>ask luigi about board
Luigi: It's a ouija board! Hey, I'll let you take a look at it if you get me something to drink. I'm a bit parched. 

 You can ask Luigi about Ouija Board, Tent, Campsite, Himself, Yourself, etc.

>give luigi canteen
The canteen is empty. You can't give Luigi an empty canteen.

>n
Forest Clearing
Here there is a lack of trees, giving a view of the stars. In the center of the clearing, there is an oddly symmetrical pond. Now that you look around, you realize that the trees on the perimeter of the surrounding fields are very similar, but don't quite mirror each other.

 You can see two paths on either side of the clearing. West is Western Field, and East is Eastern Field. You can see the cabin up ahead. North is to the cabin's front door. The path South leads to the Campsite.

* * *

>s
(first getting off the Pond)

Campsite
The campsite is surrounded with greenery. In the center of the camp is a roaring fire. Luigi is lounging around the campsite. He seems to be carrying some kind of flat, wooden object. You should try talking to him first. 

 Your pitched tent is South. North is the Forest Clearing.

>talk to luigi
Luigi: Yo! Feel free to ask me about stuff. 

 You can ask Luigi about Tent, Campsite, Board, Himself, Yourself, etc.

>give luigi canteen
Luigi: Yo, thanks! Here's the board, as promised. I forgot to mention that I don't know how to open the board. It's like it's magically shut!  No matter what I do, I can't seem to get it open. Maybe you have some idea of how to do it?

 You are now carrying the Ouija Board.

>use ouija board
That's not a verb I recognise.

>knock on ouija board
You knock once on the ouija board. Nothing appears to happen.

>knock again
I didn't understand that sentence.

>knock on oija board
I didn't understand that sentence.

>knock ouija board
I didn't understand that sentence.

>knock on ouija board
You knock once on the ouija board. Nothing appears to happen.

>knock three times on ouija board
You hear a click. The ouija board is now openable.

>open ouija board
You open the board as you would a book, and see that the inside is intact. It looks like the traditional Ouija Board, with the alphabet, numbers 0-9, "Yes" and "No" at the two top corners of the board. The planchette is fixed to the board in a way so that keeps it from falling off the board when used. Below the numbes, you read "GOOD BYE" in large letters. In the bottom hand corner of the board you read "Property of xxxx xxxxxxxx, Paranormal Investigator". 

 Luigi quietly comes up from behind you. 

 Luigi: YO! Heh, scared you didn't I? You jumped about six feet. Oh, you got the board open! I guess I'll follow you around now that things are getting interesting.Try asking the board about the spirit.

 Luigi is now following you.

>ask board about spirit
You place your hands on the planchette, and immediately after asking the question, the planchette smoothly moves to each of the four corners of the board. Then, after a moment, the planchette spells "i am here". 

 You can ask the board about the murderer, the paranormal investigator, or the remains.

>ask about luigi
You can't see any such thing.

>ask about murderer
You can't see any such thing.

>ask board about murderer
the planchette spells the words "i am". 

 You can ask the board about the paranormal investigator or the remains.

>ask board about paranormal investigator
This time, almost excitedly, the planchette spells "i killed him". Then, "axed". 

You can ask the board about the remains.

>ask board about remains
The planchette does not move for a while. Then, it slowly spells "make a mirror image". 

Luigi: What does it mean, make a mirror image? What is it asking us to do?

>ask about axe
You can't see any such thing.

>talk to luigi
Luigi doesn't feel like talking right now.

>n
Forest Clearing
Here there is a lack of trees, giving a view of the stars. In the center of the clearing, there is an oddly symmetrical pond. Now that you look around, you realize that the trees on the perimeter of the surrounding fields are very similar, but don't quite mirror each other.

 You can see two paths on either side of the clearing. West is Western Field, and East is Eastern Field. You can see the cabin up ahead. North is to the cabin's front door. The path South leads to the Campsite.

Luigi is with you.

>n
Cabin
 The room has peeling walls and a rotten wooden floor. Both seem to be splattered with a dark stain. There is no furniture in the room. 

 North of this room is the Attic. East of here is an open door leading to what looks like a bedroom.  South is Forest Clearing.

Luigi is with you.

>n
(first opening attic door)
It seems to be locked.

* * *

>e
Bedroom
Besides a bed and a dresser, the room is barren. Like the first room in the cabin, it is covered in dust. 

West is the Cabin's entrance room.

Luigi is with you.

>w
Cabin
 The room has peeling walls and a rotten wooden floor. Both seem to be splattered with a dark stain. There is no furniture in the room. 

 North of this room is the Attic. East of here is the Bedroom. South is Forest Clearing.

Luigi is with you.

>e
Bedroom
Besides a bed and a dresser, the room is barren. Like the first room in the cabin, it is covered in dust. 

West is the Cabin's entrance room.

Luigi is with you.

>x room
You can't see any such thing.

>x dresser
Even when covered with a thick coat of dust, you can see the outline of a single drawer.

* * *

>open drawer
You open the drawer to reveal an old, rusted axe. On the inside of the drawer there are dark brown stains on the wood as well as on the axe blade.

>take axe
Taken.

>w
Cabin
 The room has peeling walls and a rotten wooden floor. Both seem to be splattered with a dark stain. There is no furniture in the room. 

 North of this room is the Attic. East of here is the Bedroom. South is Forest Clearing.

Luigi is with you.

* * *

>s
Forest Clearing
Here there is a lack of trees, giving a view of the stars. In the center of the clearing, there is an oddly symmetrical pond. Now that you look around, you realize that the trees on the perimeter of the surrounding fields are very similar, but don't quite mirror each other.

 You can see two paths on either side of the clearing. West is Western Field, and East is Eastern Field. You can see the cabin up ahead. North is to the cabin's front door. The path South leads to the Campsite.

Luigi is with you.

>e
Eastern Field
There is an interesting formation of trees on the far end of the field.

 West is Forest Clearing.

Luigi is with you.

* * *

>chop down tree
You chop down the oak tree with the axe, making a tree stump just like the one in the Western field. A mirror image was made. From inside the stump, you see a wooden key.

>take wooden key
After taking the wooden key, you notice that the planchette begins to move on its own. It spells "You are brave... Now go..."

>go
You'll have to say which compass direction to go in.

>s
You can't go that way.

>w
Forest Clearing
Here there is a lack of trees, giving a view of the stars. In the center of the clearing, there is an oddly symmetrical pond. 

 You can see two paths on either side of the clearing. West is Western Field, and East is Eastern Field. You can see the cabin up ahead. North is to the cabin's front door. The path South leads to the Campsite.

* * *

>n
Cabin
 The room has peeling walls and a rotten wooden floor. Both seem to be splattered with a dark stain. There is no furniture in the room. 

 North of this room is the Attic. East of here is the Bedroom. South is Forest Clearing.

>s
Forest Clearing
Here there is a lack of trees, giving a view of the stars. In the center of the clearing, there is an oddly symmetrical pond. 

 You can see two paths on either side of the clearing. West is Western Field, and East is Eastern Field. You can see the cabin up ahead. North is to the cabin's front door. The path South leads to the Campsite.

>w
Western Field
There is an interesting formation of trees on the far end of the field.

 East is Forest Clearing.

>x stump
It looks like it was cut clean with an axe. From looking at the wood, you assume the stump used to be an oak tree.

>use key
That's not a verb I recognise.

>s
You can't go that way.

>w
You can't go that way.

>e
Forest Clearing
Here there is a lack of trees, giving a view of the stars. In the center of the clearing, there is an oddly symmetrical pond. 

 You can see two paths on either side of the clearing. West is Western Field, and East is Eastern Field. You can see the cabin up ahead. North is to the cabin's front door. The path South leads to the Campsite.

>n
Cabin
 The room has peeling walls and a rotten wooden floor. Both seem to be splattered with a dark stain. There is no furniture in the room. 

 North of this room is the Attic. East of here is the Bedroom. South is Forest Clearing.

>a
That's not a verb I recognise.

>n
(first unlocking the attic door with the wooden key, then opening the door)

Attic
The Attic is dust covered and moldy. There is a single, round window overlooking the Creek.  In the center of the room, on the floor, is a skeleton. 

 South is the Cabin's entrance room.

* * *

>x skeleton
The skeleton that looks like it could have belonged to a large man. It is impossible to tell the cause of death. On the clothes of the skeleton, there is a name card.

>read name card
You read, "xxxx xxxxxxxx, Paranormal Investigator. 

 The planchette moves one final time. Your heart feels like it has stopped when the planchette spells "You're next". You hear the attic door slam behind you.

 The skeletal remains of the Paranormal Investigator slowly animates, rising to its feet. It looks as if it is being possessed, no doubt by the spirit of the axe murderer. With startling ease, it begins to move towards you with murderous intent. You need to make a decision, and fast! For the first time, you notice a scrap of paper on the floor beside you. Picking it up, you read "Search the pond. There you will find the remains. You must burn the remains if you want to survive." Is this a dying message from the paranormal investigator?

 Luigi: What do we do?! You're not going to kill me, are you?! I say we chop down the skeleton!! Kill it before it kills us! 

You need to carefully (yet quickly) look at your surroundings and take note of your items. There is only one correct way out of this situation.

Luigi is with you.

>x surroundings
You can't see any such thing.

>l
Attic
The Attic is dust covered and moldy. There is a single, round window overlooking the Creek. The possessed skeleton monster is slowly but surely making its way towards you from the center of the room. Time is running out. 

 South is the Cabin's entrance room.

>axe luigi
Even in your final attempt to prove your bravery, you cannot bring yourself to kill your friend. The skeleton possessed by the spirit of the axe murderer is upon you. You die a coward.

    *** BAD END. ***

Would you like to RESTART, RESTORE a saved game, QUIT or UNDO the last command?

>kill luigi
Please give one of the answers above.

Would you like to RESTART, RESTORE a saved game, QUIT or UNDO the last command?

>attack luigi
Please give one of the answers above.

Would you like to RESTART, RESTORE a saved game, QUIT or UNDO the last command?

>restore
Restore failed.

Would you like to RESTART, RESTORE a saved game, QUIT or UNDO the last command?

>undo
Attic
[Previous turn undone.]

* * *

>s
The door is jammed, seemingly by some unknown force. The wooden key no longer works.

>embrace skeleton
You can only do that to something animate.

>jump through window
I only understood you as far as wanting to jump.

>jump window
I only understood you as far as wanting to jump.

>x window
It's too dark outside to see anything, but you know that you are very high up, at least 50 feet. It's a long way down.

>jump through
I only understood you as far as wanting to jump.

>leap
That's not a verb I recognise.

>leap through
That's not a verb I recognise.

>jump out window
You finally feeling like you have become a brave person. In this proud moment, you and Luigi jump out of the attic window. However, the distance to the ground is too great. In an attempt to renounce your cowardice, you fall to your death.

    *** BAD END. ***

Would you like to RESTART, RESTORE a saved game, QUIT or UNDO the last command?

>undo
Attic
[Previous turn undone.]

* * *

>l
Attic
The Attic is dust covered and moldy. There is a single, round window overlooking the Creek. The possessed skeleton monster is slowly but surely making its way towards you from the center of the room. Time is running out. 

 South is the Cabin's entrance room.

>axe skeleton
You finally feeling like you have become a brave person. In this proud moment, you swing your axe at the skull of the skeleton. However, the skeleton is swift to dodge your blow, and quickly overwhelms you. In a split second, you remember what the paranormal investigator had written in his book-- "If the spirit should somehow possess an object/body, do NOT ATTEMPT TO KILL IT. This will only result in eminent death."

 In an attempt to renounce your cowardice, you and Luigi die a pitiful death.

    *** BAD END. ***

Would you like to RESTART, RESTORE a saved game, QUIT or UNDO the last command?

>undo
Attic
[Previous turn undone.]

>breakaxe
That's not a verb I recognise.

>break axe
Cutting it up would achieve little.

>axe self
Submitting to your own cowardice, you take your own life. You die a coward.

    *** BAD END. ***

Would you like to RESTART, RESTORE a saved game, QUIT or UNDO the last command?

>undo
Attic
[Previous turn undone.]

>axe floorboards
You can't see any such thing.

>axe door
With two quick swipes of your axe, you break down the attic door. You drop the axe, and run out of the cabin, into the forest clearing. You have made the brave, but intelligent decision. Now, you must save yourself and Luigi from the spirit of the axe murderer that possesses the skeleton of the paranormal investigator. Follow the investigator's instructions carefully, time is of the essence. You can hear the skeleton racing down the attic.

Forest Clearing
Here there is a lack of trees, giving a view of the stars. In the center of the clearing, there is an oddly symmetrical pond. Now that you look around, you realize that the trees on the perimeter of the surrounding fields are very similar, but don't quite mirror each other. The trees on the perimeter of the surrounding fields create a mirror image.

 You can see two paths on either side of the clearing. West is Western Field, and East is Eastern Field. You can see the cabin up ahead. North is to the cabin's front door. The path South leads to the Campsite.

Luigi is with you.

>x trees
You can't see any such thing.

>i
You are carrying:
  Paper
  Wooden Key
  ouija board
  ouija book

>use ouija board
That's not a verb I recognise.

>x ouija board
It seems to be an old fashioned ouija board.

>knock three times on ouia board
I didn't understand that sentence.

>search pond
You might have to enter the pond to thoroughly search it.

>enter pond
You get onto the Pond.

* * *

>search pond
You follow the instructions on the piece of paper, and after digging around the pond, you see a large skull sunken beneath the surface.

>take skull
Taken.

>s
(first getting off the Pond)

Campsite
The campsite is surrounded with greenery. In the center of the camp is a roaring fire.

 Your pitched tent is South. North is the Forest Clearing.

Luigi is with you.

>toss skull into fire
That's not a verb I recognise.

>burn skull
This dangerous act would achieve little.

>torch remains
That's not a verb I recognise.

>i
You are carrying:
  Skull
  Paper
  Wooden Key
  ouija board
  ouija book

>destroy skull
Cutting it up would achieve little.

>read paper
There are no pages in Paper.

* * *

>x paper
A crumpled piece of paper. It says "Search the pond. There you will find the remains. You must burn the remains if you want to survive." Is this a dying message from the paranormal investigator?

>burn remains in fire
I only understood you as far as wanting to burn Skull.

>x fire
A blazing campfire to keep you and Luigi warm.

>toss skull
That's not a verb I recognise.

>burn skull
This dangerous act would achieve little.

>touch fire
You feel nothing unexpected.

>talk to luigi
Luigi doesn't feel like talking right now.

>toss luigi into fire
That's not a verb I recognise.

>x skull
A skull that looks like it belonged to a large man. On the frontal bone of the skull you can see a huge crack. It looks like it was made with a tool. Could it have been the cause of death?

>destroy skull
Cutting it up would achieve little.

>throw skull
Dropped.

>take skull
Taken.

>stand in fire
I only understood you as far as wanting to stand.

>throw skull into fire
That can't contain things.

>throw skull in fire
As you near the flames, you feel a growing nervousness and fear of the outcome. The planchette angrily moves rapidly from each of the corners of the board. The skeleton is almost upon you. You finally bring yourself to push away your fears, and throw the skull into the fire. The skeleton falls to pieces, and the planchette lays frozen on the board.

 Luigi: You did it... You saved us! I guess I have to admit you're not some big scaredy-cat after all.

    *** GOOD END. ***

Would you like to RESTART, RESTORE a saved game, QUIT or UNDO the last command?

* * *

>s
Tent
Your backpack sits in the corner. The sleeping bags are unrolled on the ground.

 North is the Campsite.

* * *

>n
Campsite
The campsite is surrounded with greenery. In the center of the camp is a roaring fire. Luigi is lounging around the campsite. He seems to be carrying some kind of flat, wooden object. You should try talking to him first. 

 Your pitched tent is South. North is the Forest Clearing.

>enter pond
You can't see any such thing.

>n
Forest Clearing
Here there is a lack of trees, giving a view of the stars. In the center of the clearing, there is an oddly symmetrical pond. You can see that the trees on the perimeter of the surrounding fields are very similar, but don't quite mirror each other. 

 You can see two paths on either side of the clearing. West is Western Field, and East is Eastern Field. You can see the cabin up ahead. North is to the cabin's front door. The path South leads to the Campsite.

* * *

>s
(first getting off the Pond)

Campsite
The campsite is surrounded with greenery. In the center of the camp is a roaring fire. Luigi is lounging around the campsite. He seems to be carrying some kind of flat, wooden object. You should try talking to him first. 

 Your pitched tent is South. North is the Forest Clearing.

>give luigi cnteen
You can't see any such thing.

>give canteen
(to Luigi)
Luigi: Yo, thanks! Here's the board, as promised. I forgot to mention that I don't know how to open the board. It's like it's magically shut!  No matter what I do, I can't seem to get it open. Maybe you have some idea of how to do it?

 You are now carrying the Ouija Board.

>knock 3 times on board
You hear a click. The ouija board can now be opened.

* * *

>n
Forest Clearing
Here there is a lack of trees, giving a view of the stars. In the center of the clearing, there is an oddly symmetrical pond. You can see that the trees on the perimeter of the surrounding fields are very similar, but don't quite mirror each other. 

 You can see two paths on either side of the clearing. West is Western Field, and East is Eastern Field. You can see the cabin up ahead. North is to the cabin's front door. The path South leads to the Campsite.

Luigi is with you.

* * *

>n
Cabin
 You enter the abandoned cabin.  The room has peeling walls and a rotten wooden floor. Both seem to be splattered with a dark stain. There is no furniture in the room, besides a single book lying in the middle of the floor. 

 North of this room is the Attic. East of here is an open door leading to what looks like a bedroom.  South is Forest Clearing.

Luigi is with you.

>e
Bedroom
Besides a bed and a dresser, the room is barren. Like the first room in the cabin, it is covered in dust. 

West is the Cabin's entrance room.

Luigi is with you.

* * *

>take axe
Taken.

>w
Cabin
 The room has peeling walls and a rotten wooden floor. Both seem to be splattered with a dark stain. There is no furniture in the room, besides a single book lying in the middle of the floor. 

 North of this room is the Attic. East of here is the Bedroom. South is Forest Clearing.

Luigi is with you.

* * *

>e
Eastern Field
There is an interesting formation of trees on the far end of the field.

 West is Forest Clearing.

Luigi is with you.

>chop tree
You chop down the oak tree with the axe, making a tree stump just like the one in the Western field. A mirror image was made. From inside the stump, you see a wooden key.

>take key
After taking the wooden key, you notice that the planchette begins to move on its own. It spells "You are brave... Now go..."

 For once, you really do feel brave. And even stranger, you feel inclinced to listen to the spirit.

* * *

>smell
You smell nothing unexpected.

>listen
You hear nothing unexpected.

>smell
You smell nothing unexpected.

>l
Attic
The Attic is dust covered and moldy. There is a single, round window overlooking the Creek. The possessed skeleton monster is slowly but surely making its way towards you from the center of the room. Time is running out. 

 South is the Cabin's entrance room.

>smekk
That's not a verb I recognise.

>x window
It's too dark outside to see anything, but you know that you are very high up, at least 50 feet. It's a long way down.

>smell
You smell nothing unexpected.

* * *

>give canteen
(to Luigi)
Luigi: Yo, thanks! Here's the board, as promised. I forgot to mention that I don't know how to open the board. It's like it's magically shut!  No matter what I do, I can't seem to get it open. Maybe you have some idea of how to do it?

 You are now carrying the Ouija Board.

>knock on board 3 times
You hear a click. The ouija board can now be opened.

>open board
You open the board as you would a book, and see that the inside is intact. It looks like the traditional Ouija Board, with the alphabet, numbers 0-9, "Yes" and "No" at the two top corners of the board. The planchette is fixed to the board in a way so that keeps it from falling off the board when used. Below the numbes, you read "GOOD BYE" in large letters. In the bottom hand corner of the board you read "Property of xxxx xxxxxxxx, Paranormal Investigator". 

 Luigi quietly comes up from behind you. 

 Luigi: YO! Heh, scared you didn't I? You jumped about six feet. Oh, you got the board open! I guess I'll follow you around now that things are getting interesting.Try asking the board about the spirit.

 Luigi is now following you.

>n
Forest Clearing
Here there is a lack of trees, giving a view of the stars. In the center of the clearing, there is an oddly symmetrical pond. You can see that the trees on the perimeter of the surrounding fields are very similar, but don't quite mirror each other. 

 You can see two paths on either side of the clearing. West is Western Field, and East is Eastern Field. You can see the cabin up ahead. North is to the cabin's front door. The path South leads to the Campsite.

Luigi is with you.

* * *

>n
(first unlocking the attic door with the wooden key, then opening the door)

Attic
The Attic is dust covered and moldy. There is a single, round window overlooking the Creek.  In the center of the room, on the hard floor, is a skeleton. 

 South is the Cabin's entrance room.

>x name card
You read, "xxxx xxxxxxxx, Paranormal Investigator. 

 The planchette moves one final time. Your heart feels like it has stopped in your chest. The planchette spells "Prove your bravery and kill your friend. Or you will both die". You hear the attic door slam behind you.

 The skeletal remains of the Paranormal Investigator slowly animates, rising to its feet. It looks as if it is being possessed, no doubt by the spirit of the axe murderer. With startling ease, it begins to move towards you with murderous intent. You need to make a decision, and fast! For the first time, you notice a scrap of paper on the floor beside you. Picking it up, you read "Search the pond. There you will find the remains. You must burn the remains if you want to survive." Is this a dying message from the paranormal investigator?

 Luigi: What do we do?! You're not going to kill me, are you?! I say we chop down the skeleton!! Kill it before it kills us! 

You need to carefully (yet quickly, time and turns used now count. There is a clock in the upper right hand corner.) look at your surroundings and take note of your items. There is only one correct way out of this situation.

Luigi is with you.

>liten
That's not a verb I recognise.

>l
Attic
The Attic is dust covered and moldy. There is a single, round window overlooking the Creek. The possessed skeleton monster is slowly but surely making its way towards you from the center of the room. Time is running out. 

 South is the Cabin's entrance room.

>s
The door is jammed, seemingly by some unknown force. The wooden key no longer works.

The possessed skeleton is quickly advancing towards you. Hurry!

>x window
It's too dark outside to see anything, but you know that you are very high up, at least 50 feet. It's a long way down.

I beg your pardon?

>x skeleton
The skeleton that looks like it could have belonged to a large man. It is impossible to tell the cause of death. On the clothes of the skeleton, there is a name card.

The skeleton is almost upon you....

>x window
It's too dark outside to see anything, but you know that you are very high up, at least 50 feet. It's a long way down.

>undo
Attic
[Previous turn undone.]

>axe door
With two quick swipes of your axe, you break down the attic door. You drop the axe, and run out of the cabin, into the forest clearing. You have made the brave, but intelligent decision. Now, you must save yourself and Luigi from the spirit of the axe murderer that possesses the skeleton of the paranormal investigator. Follow the investigator's instructions carefully, time is of the essence. You can hear the skeleton racing down the attic.

Forest Clearing
Here there is a lack of trees, giving a view of the stars. In the center of the clearing, there is an oddly symmetrical pond. You can see that the trees on the perimeter of the surrounding fields are very similar, but don't quite mirror each other. 

 You can see two paths on either side of the clearing. West is Western Field, and East is Eastern Field. You can see the cabin up ahead. North is to the cabin's front door. The path South leads to the Campsite.

Luigi is with you.

>s
Campsite
The campsite is surrounded with greenery. In the center of the camp is a roaring fire.

 Your pitched tent is South. North is the Forest Clearing.

Luigi is with you.

>n
Forest Clearing
Here there is a lack of trees, giving a view of the stars. In the center of the clearing, there is an oddly symmetrical pond. You can see that the trees on the perimeter of the surrounding fields are very similar, but don't quite mirror each other. 

 You can see two paths on either side of the clearing. West is Western Field, and East is Eastern Field. You can see the cabin up ahead. North is to the cabin's front door. The path South leads to the Campsite.

Luigi is with you.

>enter pond
You get onto the Pond.

The skeleton is relentlessly chasing after you. The sounds of its footsteps grow louder. It sounds like it's swinging something-- the axe you dropped?

>take canteen
That seems to belong to Luigi.

>search pond
You follow the instructions on the piece of paper, and after digging around the pond, you see a large skull sunken beneath the surface.

You see the skeleton emerging from behind several trees, swinging the rusted axe as the spirit possessing it did in life. Hurry, before it's too late!

>take skull
Taken.

* * *

>s
Tent
Your backpack sits in the corner. The sleeping bags are unrolled on the ground.

 North is the Campsite.

>take canteen
You can't see any such thing.

>open backpack
You open Backpack, revealing Canteen.

>take canteen
Taken.

>n
Campsite
The campsite is surrounded with greenery. In the center of the campsite a roaring camfire blazes. Luigi is lounging around the campsite. He seems to be carrying an old, wooden board of some sort. 

 Your pitched tent is South. North is the Forest Clearing.

>n
Forest Clearing
Here there is a lack of trees, giving a view of the stars. In the center of the clearing, there is an oddly symmetrical pond. Now that you look around, you realize that the trees on the perimeter of the clearing seem to mirror each other. 

 You can see two paths on either side of the clearing. West is Western Field, and East is Eastern Field. You can see a cabin up ahead. North is to the cabin's front door. The path South leads to the Campsite.

The perfect-circle pond is serene, and so clear that you can see the bottom. There seems to be nothing alive in the pond.

>fill canteen
(with Canteen)
You have to be in water to fill it.

>s
Campsite
The campsite is surrounded with greenery. In the center of the campsite a roaring camfire blazes. Luigi is lounging around the campsite. He seems to be carrying an old, wooden board of some sort. 

 Your pitched tent is South. North is the Forest Clearing.

>s
Tent
Your backpack sits in the corner. The sleeping bags are unrolled on the ground.

>n
Campsite
The campsite is surrounded with greenery. In the center of the campsite a roaring camfire blazes. Luigi is lounging around the campsite. He seems to be carrying an old, wooden board of some sort. 

 Your pitched tent is South. North is the Forest Clearing.

>give canteen to luigi
Luigi: Yo, thanks! Here's the board, as promised. I forgot to mention that I don't know how to open the board. It's like it's magically shut!  No matter what I do, I can't seem to get it open. Maybe you have some idea of how to do it?

 You are now carrying the Ouija Board.

>knock on ouija board 3 times
You hear a click. The ouija board is now openable.

>open ouija board
You open the board as you would a book, and see that the inside is intact. It looks like the traditional Ouija Board, with the alphabet, numbers 0-9, "Yes" and "No" at the two top corners of the board. The planchette is fixed to the board in a way so that keeps it from falling off the board when used. Below the numbes, you read "GOOD BYE" in large letters. In the bottom hand corner of the board you read "Property of xxxx xxxxxxxx, Paranormal Investigator". 

 You notice that Luigi comes up from behind you. 

 Luigi: Yo! You got the board open. Try asking the board about the spirit.

>ask ouija board about the spirit
You place your hands on the planchette, and immediately after asking the question, the planchette smoothly moves across the alphabet, spelling "i am here". 

 You can ask the board about the murderer, the paranormal investigator, or the remains.

>ask ouija board about the remains
The planchette does not move for a while. Then, it slowly spells "make a mirror image". 

Luigi: What does it mean, make a mirror image? What is it asking us to do?

>ask ouija board about hint
The planchette spells out "Axes make mirrors. Life and death are mirrors. Young and old, rich and poor.  East and West are mirrors as well. 

 Luigi: Something about east and west???

>north
Forest Clearing
Here there is a lack of trees, giving a view of the stars. In the center of the clearing, there is an oddly symmetrical pond. Now that you look around, you realize that the trees on the perimeter of the clearing seem to mirror each other. 

 You can see two paths on either side of the clearing. West is Western Field, and East is Eastern Field. You can see a cabin up ahead. North is to the cabin's front door. The path South leads to the Campsite.

The perfect-circle pond is serene, and so clear that you can see the bottom. There seems to be nothing alive in the pond.

>north
Cabin
 You enter the abandoned cabin.  The room has peeling walls and a rotten wooden floor. Both seem to be splattered with a dark stain. There is no furniture in the room. 

 North of this room is  a door that must lead to the Attic. East of here is  an open door leading to what looks like a bedroom.  the Bedroom. South is Forest Clearing.

>s
Forest Clearing
Here there is a lack of trees, giving a view of the stars. In the center of the clearing, there is an oddly symmetrical pond. Now that you look around, you realize that the trees on the perimeter of the clearing seem to mirror each other. 

 You can see two paths on either side of the clearing. West is Western Field, and East is Eastern Field. You can see a cabin up ahead. North is to the cabin's front door. The path South leads to the Campsite.

The perfect-circle pond is serene, and so clear that you can see the bottom. There seems to be nothing alive in the pond.

>s
Campsite
The campsite is surrounded with greenery. In the center of the campsite a roaring camfire blazes. Luigi is lounging around the campsite. He seems to be carrying an old, wooden board of some sort. 

 Your pitched tent is South. North is the Forest Clearing.

>n
Forest Clearing
Here there is a lack of trees, giving a view of the stars. In the center of the clearing, there is an oddly symmetrical pond. Now that you look around, you realize that the trees on the perimeter of the clearing seem to mirror each other. 

 You can see two paths on either side of the clearing. West is Western Field, and East is Eastern Field. You can see a cabin up ahead. North is to the cabin's front door. The path South leads to the Campsite.

The perfect-circle pond is serene, and so clear that you can see the bottom. There seems to be nothing alive in the pond.

>e
Eastern Field
There is an interesting formation of trees on the far end of the field.

>chop down oak tree
You have nothing to cut it down with.

>take wooden key
After taking the wooden key, you notice that the planchette begins to move on its own. It spells "You are brave... Now go..."

>n
You can't go that way.

>w
Forest Clearing
Here there is a lack of trees, giving a view of the stars. In the center of the clearing, there is an oddly symmetrical pond. Now that you look around, you realize that the trees on the perimeter of the clearing seem to mirror each other. 

 You can see two paths on either side of the clearing. West is Western Field, and East is Eastern Field. You can see a cabin up ahead. North is to the cabin's front door. The path South leads to the Campsite.

The perfect-circle pond is serene, and so clear that you can see the bottom. There seems to be nothing alive in the pond.

>n
Cabin
 The room has peeling walls and a rotten wooden floor. Both seem to be splattered with a dark stain. There is no furniture in the room. 

 North of this room is  a door that must lead to the Attic. East of here is  an open door leading to what looks like a bedroom.  the Bedroom. South is Forest Clearing.