Your good friend Luigi has invited you to go camping with him over the weekend to Axe Creek, an abondoned camp site infamous for its reports of mysterious casualties and missing persons. Being a timid and not-so adventurous person, it took lots of convincing before you agreed to go. You decided that this could be your chance to prove to yourself that you're not a big baby. You can survive a single weekend in the woods, right?

Ouija Boredom
An Interactive Fiction by Lee-Won Fulbright
Release 1 / Serial number 141024 / Inform 7 build 6L38 (I6/v6.33 lib 6/12N) SD

Campsite
The campsite is surrounded with greenery. In the center of the campsite a roaring camfire blazes. Luigi is lounging around the campsite. He seems to be carrying an old, wooden board of some sort. 

 Your pitched tent is South. North is the Forest Clearing.

>ask about poo
Luigi will only answer certain questions. You can ask Luigi about "Ouija Boards", "Patch of Dirt",

* * *

>ask about book
You play a nice scale. Nothing else happens, though.

>ask about poop
Luigi will only answer certain questions. You can ask Luigi about "Ouija Boards", "Patch of Dirt",  "book", "tent", "campsite", "himself"

>ask about yourself
I can't believe you had the guts to come camping out here!

* * *

>ask
(Luigi for Luigi)
(Luigi first taking Luigi)
Luigi has better things to do.

>ask about poo
You can ask Luigi about "Ouija Boards", "Patch of Dirt",  "Cabin".

* * *

>ask about cabin
Luigi: Some creepy old cabin. I wonder who used to live there. There has to be some way to unlock the door.

>n
Forest Clearing
Here there is a lack of trees, giving a view of the stars. In the center of the clearing, there is an oddly symmetrical pond. Now that you look around, you realize that the trees on the perimeter of the clearing seem to mirror each other. 

 You can see two paths on either side of the clearing. West is Western Field, and East is Eastern Field. You can see a cabin up ahead. North is to the cabin's front door. The path South leads to the Campsite.

The perfect-circle pond is serene, and so clear that you can see the bottom. There seems to be nothing alive in the pond.

>s
Campsite
The campsite is surrounded with greenery. You notice an uneven patch of dirt in the ground. 

 Your pitched tent is south.

Luigi is lounging around the campsite. He seems to be preoccupied with reading a strange book.

>s
Tent
Your backpack sits in the corner. The sleeping bags are unrolled on the ground.

>open backpack
You open Backpack, revealing Canteen.

>take canteen
Taken.

>n
Campsite
The campsite is surrounded with greenery. You notice an uneven patch of dirt in the ground. 

 Your pitched tent is south.

Luigi is lounging around the campsite. He seems to be preoccupied with reading a strange book.

>n
Forest Clearing
Here there is a lack of trees, giving a view of the stars. In the center of the clearing, there is an oddly symmetrical pond. Now that you look around, you realize that the trees on the perimeter of the clearing seem to mirror each other. 

 You can see two paths on either side of the clearing. West is Western Field, and East is Eastern Field. You can see a cabin up ahead. North is to the cabin's front door. The path South leads to the Campsite.

The perfect-circle pond is serene, and so clear that you can see the bottom. There seems to be nothing alive in the pond.

>enter pond
You get onto Pond.

>exit pond
I only understood you as far as wanting to exit.

>s
(first getting off Pond)

Campsite
The campsite is surrounded with greenery. You notice an uneven patch of dirt in the ground. 

 Your pitched tent is south.

Luigi is lounging around the campsite. He seems to be preoccupied with reading a strange book.

>n
Forest Clearing
Here there is a lack of trees, giving a view of the stars. In the center of the clearing, there is an oddly symmetrical pond. Now that you look around, you realize that the trees on the perimeter of the clearing seem to mirror each other. 

 You can see two paths on either side of the clearing. West is Western Field, and East is Eastern Field. You can see a cabin up ahead. North is to the cabin's front door. The path South leads to the Campsite.

The perfect-circle pond is serene, and so clear that you can see the bottom. There seems to be nothing alive in the pond.

>fill canteen
(with Canteen)
You have to be in water to fill it.

>enter pond
You get onto Pond.

>fill canteen
(with Canteen)
You filled the canteen with the pond water.

>s
(first getting off Pond)

Campsite
The campsite is surrounded with greenery. You notice an uneven patch of dirt in the ground. 

 Your pitched tent is south.

Luigi is lounging around the campsite. He seems to be preoccupied with reading a strange book.

>give water
You can't see any such thing.

>give water to luigi
You can't see any such thing.

>give canteen to luigi
Luigi doesn't seem interested.

* * *

>n
Forest Clearing
Here there is a lack of trees, giving a view of the stars. In the center of the clearing, there is an oddly symmetrical pond. Now that you look around, you realize that the trees on the perimeter of the clearing seem to mirror each other. 

 You can see two paths on either side of the clearing. West is Western Field, and East is Eastern Field. You can see a cabin up ahead. North is to the cabin's front door. The path South leads to the Campsite.

The perfect-circle pond is serene, and so clear that you can see the bottom. There seems to be nothing alive in the pond.

>s
Campsite
The campsite is surrounded with greenery. In the center of the campsite a roaring camfire blazes. Luigi is lounging around the campsite. He seems to be carrying an old, wooden board of some sort. 

 Your pitched tent is South. North is the Forest Clearing.

>s
Tent
Your backpack sits in the corner. The sleeping bags are unrolled on the ground.

>open tent
You can't see any such thing.

>open backpack
You open Backpack, revealing Canteen.

* * *

>take canteen
Taken.

>n
Campsite
The campsite is surrounded with greenery. In the center of the campsite a roaring camfire blazes. Luigi is lounging around the campsite. He seems to be carrying an old, wooden board of some sort. 

 Your pitched tent is South. North is the Forest Clearing.

>n
Forest Clearing
Here there is a lack of trees, giving a view of the stars. In the center of the clearing, there is an oddly symmetrical pond. Now that you look around, you realize that the trees on the perimeter of the clearing seem to mirror each other. 

 You can see two paths on either side of the clearing. West is Western Field, and East is Eastern Field. You can see a cabin up ahead. North is to the cabin's front door. The path South leads to the Campsite.

The perfect-circle pond is serene, and so clear that you can see the bottom. There seems to be nothing alive in the pond.

>enter pond
You step into the pond.

Forest Clearing (on Pond)
Here there is a lack of trees, giving a view of the stars. In the center of the clearing, there is an oddly symmetrical pond. Now that you look around, you realize that the trees on the perimeter of the clearing seem to mirror each other. 

 You can see two paths on either side of the clearing. West is Western Field, and East is Eastern Field. You can see a cabin up ahead. North is to the cabin's front door. The path South leads to the Campsite.

>take canteen
You already have that.

>fill canteen
(with Canteen)
You filled the canteen with the pond water.

>s
(first getting off Pond)

Campsite
The campsite is surrounded with greenery. In the center of the campsite a roaring camfire blazes. Luigi is lounging around the campsite. He seems to be carrying an old, wooden board of some sort. 

 Your pitched tent is South. North is the Forest Clearing.

>give canteen to luigi
Luigi: Yo, thanks! Here's the board, as promised. I forgot to mention that I don't know how to open the board. It's like it's magically shut!  No matter what I do, I can't seem to get it open. Maybe you have some idea of how to do it?

 You are now carrying the Ouija Board.

>open ouija board
Luigi is right, it seems to be closed shut like magic. Maybe you can find a way to open it.

>n
Forest Clearing
Here there is a lack of trees, giving a view of the stars. In the center of the clearing, there is an oddly symmetrical pond. Now that you look around, you realize that the trees on the perimeter of the clearing seem to mirror each other. 

 You can see two paths on either side of the clearing. West is Western Field, and East is Eastern Field. You can see a cabin up ahead. North is to the cabin's front door. The path South leads to the Campsite.

The perfect-circle pond is serene, and so clear that you can see the bottom. There seems to be nothing alive in the pond.

>e
Eastern Field
There is an interesting formation of trees on the far end of the field.

>x trees
You can't see any such thing.

>w
Forest Clearing
Here there is a lack of trees, giving a view of the stars. In the center of the clearing, there is an oddly symmetrical pond. Now that you look around, you realize that the trees on the perimeter of the clearing seem to mirror each other. 

 You can see two paths on either side of the clearing. West is Western Field, and East is Eastern Field. You can see a cabin up ahead. North is to the cabin's front door. The path South leads to the Campsite.

The perfect-circle pond is serene, and so clear that you can see the bottom. There seems to be nothing alive in the pond.

>e
Eastern Field
There is an interesting formation of trees on the far end of the field.

>w
Forest Clearing
Here there is a lack of trees, giving a view of the stars. In the center of the clearing, there is an oddly symmetrical pond. Now that you look around, you realize that the trees on the perimeter of the clearing seem to mirror each other. 

 You can see two paths on either side of the clearing. West is Western Field, and East is Eastern Field. You can see a cabin up ahead. North is to the cabin's front door. The path South leads to the Campsite.

The perfect-circle pond is serene, and so clear that you can see the bottom. There seems to be nothing alive in the pond.

>s
Campsite
The campsite is surrounded with greenery. In the center of the campsite a roaring camfire blazes. Luigi is lounging around the campsite. He seems to be carrying an old, wooden board of some sort. 

 Your pitched tent is South. North is the Forest Clearing.

>n
Forest Clearing
Here there is a lack of trees, giving a view of the stars. In the center of the clearing, there is an oddly symmetrical pond. Now that you look around, you realize that the trees on the perimeter of the clearing seem to mirror each other. 

 You can see two paths on either side of the clearing. West is Western Field, and East is Eastern Field. You can see a cabin up ahead. North is to the cabin's front door. The path South leads to the Campsite.

The perfect-circle pond is serene, and so clear that you can see the bottom. There seems to be nothing alive in the pond.

>w
Western Field
There is an interesting formation of trees on the far end of the field.

>x trees
You count five identical trees, all growing in a straight row. On one end of the row of trees, there is a tree stump.

>e
Forest Clearing
Here there is a lack of trees, giving a view of the stars. In the center of the clearing, there is an oddly symmetrical pond. Now that you look around, you realize that the trees on the perimeter of the clearing seem to mirror each other. 

 You can see two paths on either side of the clearing. West is Western Field, and East is Eastern Field. You can see a cabin up ahead. North is to the cabin's front door. The path South leads to the Campsite.

The perfect-circle pond is serene, and so clear that you can see the bottom. There seems to be nothing alive in the pond.

>n
Cabin
 You enter the abandoned cabin.  The room has peeling walls and a rotten wooden floor. Both seem to be splattered with a dark stain. There is no furniture in the room. 

 North of this room is  a door that must lead to the Attic. East of here is  an open door leading to what looks like a bedroom.  the Bedroom. South is Forest Clearing.

>l
Cabin
 The room has peeling walls and a rotten wooden floor. Both seem to be splattered with a dark stain. There is no furniture in the room. 

 North of this room is  a door that must lead to the Attic. East of here is  an open door leading to what looks like a bedroom.  the Bedroom. South is Forest Clearing.

>n
(first opening attic door)
It seems to be locked.

>e
Bedroom
Besides a bed and a dresser, the room is barren. Like the first room in the cabin, it is covered in dust. West is Cabin.

>open dresser
You open the drawer to reveal an old, rusted axe. On the inside of the drawer there are dark brown stains on the wood as well as on the axe blade.

>take axe
Taken.

>x axe
A gigantic axe. It looks like it was used very often, as the blade is a bit rusted and chipped. However, the axe seems to have retained its menacing look.

>inventory
You are carrying:
  axe
  ouija board

>w
Cabin
 The room has peeling walls and a rotten wooden floor. Both seem to be splattered with a dark stain. There is no furniture in the room. 

 North of this room is  a door that must lead to the Attic. East of here is  the Bedroom. South is Forest Clearing.

>x book
An odd, worn book. The cover reads:  Beware of Ouija.  There seems to be four pages in the Ouija Book, though many of the words are smudged and indecipherable. Start by reading page 1 of Ouija Book.

>read book
You need to pick up the book first.

>take book
Taken.

>read ouija book
An odd, worn book. The cover reads:  Beware of Ouija.  There seem to be four pages in the Ouija Book, though many of the words are smudged and indecipherable. Start by reading page 1 of Ouija Book.

>read pafe 1 of ouija book
You can't see any such thing.

>read page 1 of ouija book
You read: " Entry One. xx/xx/xxxx.  I am writing this diary to record my investigations of the axe murder house, located in this very forest in xxxxxxx. I am the famous paranormal invesitgator, xxxx xxxxxxxx. I have come here with the intentions of contacting the spirit of the axe murderer, xxxxxxxx xxx, who died in these woods xx years ago. Reasons behind these murders as well as facts on the killer are unknown. To uncover these mysteries, I plan to contact the spirit of the murderer himself using my ouija board. Also known as the Witch Board, the Ouija Board is an ancient tool used to form a connection with the departed, first used by the Chinese in 1100 AD. Tomorrow night, here in the cabin, I will attempt to make spiritual contact through the board."

>read next page
What do you want to read that in?

>turn page of ouija book
You can't see any such thing.

>read next page of ouija book
You read: " Entry Two. xx/xx/xxxx.  Night has fallen, and I am ready to open the board and begin communication with xxxxxxxx xxx. I am quite proud of my special Ouija board. It is unique in that you must knock three times on the board to open it. This insures that not just anyone can have easy access to the board, as using a ouija board is quite dangerous. After opening the board, I will place my hands on the planchette and ready myself both mentally and physically to encounter xxxxxxxx xxx's malevolent spirit. Anyone who's used a ouija board before knows that if the planchette moves to each of the four corners of the board, you have contacted an evil spirit. So, that's what I'm keeping an eye out for while I'm searching for the axe murderer's spirit."

>read next page of ouija book
You read: " Entry Three. xx/xx/xxxx.  I did it-- I reached the spirit of xxxxxxxx xxx. His spirit is unlike any I have come into contact with. It responds much faster, and with much greater intelligence than those of most entities. It is powerful, that much is apparent. I must remain wary of xxxxxxxx xxx's malicious intent; false flattery and lies are only to be expected from the likes of it. If anything begins to go wrong, I will simply exit the conversation by moving the planchette to the part of the board "GOOD BYE", which should sever the connection between the spirit and myself. My goal is to inquire about the final resting place of xxxxxxxx xxx, find the remains, and burn them. Hopefully, by doing this, the spirit will be put to rest."

>read next page of ouija book
You read: " Final Entry. xx/xx/xxxx.  N o ! This cannot be happening! I have lost control of the planchette, and am unable to exit through the normal means of "GOODBYE". I was a fool. I was nave. The spirit was too cunning. I am frant cally writing t is to anyo e who fi s my d ary or my ouija b ard. D o not fall vic im to the spir t!  And wha ever yo u do, do not burn t e  o ija boa d!!!!"

>read next page of ouija book
There are only four pages in the book.

>knock on ouija board
You knock once on the ouija board. Nothing appears to happen.

>knock on ouija board 3 times
You feel the Entity follow you here through the Ouija Board.

>close ouija book
It isn't something you can close.

>n
(first opening attic door)
It seems to be locked.

>n
(first opening attic door)
It seems to be locked.

>knock on youija board
I didn't understand that sentence.

>s
Forest Clearing
Here there is a lack of trees, giving a view of the stars. In the center of the clearing, there is an oddly symmetrical pond. Now that you look around, you realize that the trees on the perimeter of the clearing seem to mirror each other. 

 You can see two paths on either side of the clearing. West is Western Field, and East is Eastern Field. You can see a cabin up ahead. North is to the cabin's front door. The path South leads to the Campsite.

The perfect-circle pond is serene, and so clear that you can see the bottom. There seems to be nothing alive in the pond.

>s
Campsite
The campsite is surrounded with greenery. In the center of the campsite a roaring camfire blazes. Luigi is lounging around the campsite. He seems to be carrying an old, wooden board of some sort. 

 Your pitched tent is South. North is the Forest Clearing.

>open ouija board
Luigi is right, it seems to be closed shut like magic. Maybe you can find a way to open it.

>knock on ouija board
You knock once on the ouija board. Nothing appears to happen.

* * *

>knock on ouija board 3 times
You feel the Entity follow you here through the Ouija Board.

>e
You can't go that way.

>s
Tent
Your backpack sits in the corner. The sleeping bags are unrolled on the ground.

>n
Campsite
The campsite is surrounded with greenery. In the center of the campsite a roaring camfire blazes. Luigi is lounging around the campsite. He seems to be carrying an old, wooden board of some sort. 

 Your pitched tent is South. North is the Forest Clearing.

>inventory
You are carrying:
  ouija book
  axe
  ouija board

>s
Tent
Your backpack sits in the corner. The sleeping bags are unrolled on the ground.

>s
You can't go that way.

>n
Campsite
The campsite is surrounded with greenery. In the center of the campsite a roaring camfire blazes. Luigi is lounging around the campsite. He seems to be carrying an old, wooden board of some sort. 

 Your pitched tent is South. North is the Forest Clearing.

* * *

>s
Tent
Your backpack sits in the corner. The sleeping bags are unrolled on the ground.

>e
You can't go that way.

>n
Campsite
The campsite is surrounded with greenery. In the center of the campsite a roaring camfire blazes. Luigi is lounging around the campsite. He seems to be carrying an old, wooden board of some sort. 

 Your pitched tent is South. North is the Forest Clearing.

* * *

>n
Forest Clearing
Here there is a lack of trees, giving a view of the stars. In the center of the clearing, there is an oddly symmetrical pond. Now that you look around, you realize that the trees on the perimeter of the clearing seem to mirror each other. 

 You can see two paths on either side of the clearing. West is Western Field, and East is Eastern Field. You can see a cabin up ahead. North is to the cabin's front door. The path South leads to the Campsite.

The perfect-circle pond is serene, and so clear that you can see the bottom. There seems to be nothing alive in the pond.

>knock 3 times on ouija board
The Ouija Board opens with a click.

* * *

>n
Forest Clearing
Here there is a lack of trees, giving a view of the stars. In the center of the clearing, there is an oddly symmetrical pond. Now that you look around, you realize that the trees on the perimeter of the clearing seem to mirror each other. 

 You can see two paths on either side of the clearing. West is Western Field, and East is Eastern Field. You can see a cabin up ahead. North is to the cabin's front door. The path South leads to the Campsite.

The perfect-circle pond is serene, and so clear that you can see the bottom. There seems to be nothing alive in the pond.

>n
Cabin
 You enter the abandoned cabin.  The room has peeling walls and a rotten wooden floor. Both seem to be splattered with a dark stain. There is no furniture in the room. 

 North of this room is  a door that must lead to the Attic. East of here is  an open door leading to what looks like a bedroom.  the Bedroom. South is Forest Clearing.

>e
Bedroom
Besides a bed and a dresser, the room is barren. Like the first room in the cabin, it is covered in dust. West is Cabin.

>take axe
Taken.

>w
Cabin
 The room has peeling walls and a rotten wooden floor. Both seem to be splattered with a dark stain. There is no furniture in the room. 

 North of this room is  a door that must lead to the Attic. East of here is  the Bedroom. South is Forest Clearing.

>s
Forest Clearing
Here there is a lack of trees, giving a view of the stars. In the center of the clearing, there is an oddly symmetrical pond. Now that you look around, you realize that the trees on the perimeter of the clearing seem to mirror each other. 

 You can see two paths on either side of the clearing. West is Western Field, and East is Eastern Field. You can see a cabin up ahead. North is to the cabin's front door. The path South leads to the Campsite.

The perfect-circle pond is serene, and so clear that you can see the bottom. There seems to be nothing alive in the pond.

>e
Eastern Field
There is an interesting formation of trees on the far end of the field.

>x trees
You see five identical birch trees (name: Eastern Birch Trees), all growing in a straight row. On one end of the row of trees, there is an oak tree .

>chop down tree
You chop down the oak tree with the axe, making a tree stump just like the one in the Western field. A mirror image was made. From inside the stump, you see a wooden key.

>take wooden key
After taking the wooden key, you notice that the planchette begins to move on its own. It spells "You are brave... Now go..."

>inventory
You are carrying:
  Wooden Key
  axe

>w
Forest Clearing
Here there is a lack of trees, giving a view of the stars. In the center of the clearing, there is an oddly symmetrical pond. Now that you look around, you realize that the trees on the perimeter of the clearing seem to mirror each other. 

 You can see two paths on either side of the clearing. West is Western Field, and East is Eastern Field. You can see a cabin up ahead. North is to the cabin's front door. The path South leads to the Campsite.

The perfect-circle pond is serene, and so clear that you can see the bottom. There seems to be nothing alive in the pond.

>n
Cabin
 The room has peeling walls and a rotten wooden floor. Both seem to be splattered with a dark stain. There is no furniture in the room. 

 North of this room is  a door that must lead to the Attic. East of here is  the Bedroom. South is Forest Clearing.

>n
(first unlocking the attic door with the wooden key, then opening the door)

Attic
The Attic is dust covered and moldy. In the center of the room, on the floor, is a skeleton.

>close ouija board
You must supply a noun.

>close the ouija board
You can't see any such thing.

>inventory
You are carrying:
  Wooden Key
  axe

>n
You can't go that way.

>x name card
You read, "xxxx xxxxxxxx, Paranormal Investigator. 

 The planchette moves one final time. "You're next", it spells. You hear the attic door lock behind you.

    *** END. ***

Would you like to RESTART, RESTORE a saved game, QUIT or UNDO the last command?

>read name card
Please give one of the answers above.

Would you like to RESTART, RESTORE a saved game, QUIT or UNDO the last command?

>examine name card
Please give one of the answers above.

Would you like to RESTART, RESTORE a saved game, QUIT or UNDO the last command?

* * *

>s
Tent
Your backpack sits in the corner. The sleeping bags are unrolled on the ground.

>open back pack
You can't see any such thing.

>open backpack
You open Backpack, revealing Canteen.

* * *

>enter pond
You get onto Pond.

>take canteen
You already have that.

* * *

>s
(first getting off Pond)

Campsite
The campsite is surrounded with greenery. You notice an uneven patch of dirt in the ground. 

 Your pitched tent is south.

Luigi is lounging around the campsite. He seems to be preoccupied with reading a strange book.

>give canteen to luigi
Luigi: Yo thanks! Here's the book, as promised.

 You are now carrying the Ouija Book.

>open ouija book
It isn't something you can open.

>x ouija book
An odd, worn book. The cover reads: Beware of Ouija Boards. There seem to be five pages in the book, though many of the words are smudged and indecipherable.

>read page one
You can't see any such thing.

>read 1
You can't see any such thing.

>read 1 in ouija board
You can't see any such thing.

>read page 1 in ouija board
You can't see any such thing.

>read page 2 of ouija book
You can't see any such thing.

>read 2 of ouija book
You can't use multiple objects with that verb.

>read the first page of ouija board
You can't see any such thing.

>read the first page of ouija book
You can't see any such thing.

I beg your pardon?

>read book
What page do you want to read in the book?

>read the history of ouija boards in ouija book
You can't see any such thing.

>read 1 page of ouija book
You can't see any such thing.

>read page one of ouija book
You can't see any such thing.

>read page 1 of ouija book
You can't see any such thing.

>read the first page in book
You can't see any such thing.

>read 1 in book
You can't see any such thing.

>read page 1 in book
You can't see any such thing.

>read book
What page do you want to read in the book?

* * *

>read page one in ouija book
You can't see any such thing.

>read page one in ouija book
You can't see any such thing.

>read page 1 in ouija book
You can't see any such thing.

>read page 1 in the ouija book
You can't see any such thing.

>read page 1 in ouija book
You can't see any such thing.

* * *

I beg your pardon?

* * *

>pee in book
That's not a verb I recognise.

>read book
What page do you want to read in the book?

* * *

>s
Tent
Your backpack sits in the corner. The sleeping bags are unrolled on the ground.

>take canteen
You can't see any such thing.

>open backpack
You open Backpack, revealing Canteen.

* * *

>fill canteen
(with Canteen)
You have to be in water to fill it.

>s
Campsite
The campsite is surrounded with greenery. In the center of the campsite a roaring camfire blazes. Luigi is lounging around the campsite. He seems to be carrying an old, wooden board of some sort. 

 Your pitched tent is South. North is the Forest Clearing.

* * *

>n
Campsite
The campsite is surrounded with greenery. In the center of the campsite a roaring camfire blazes. Luigi is lounging around the campsite. He seems to be carrying an old, wooden board of some sort. 

 Your pitched tent is South. North is the Forest Clearing.

>give canteen to luigi
Luigi: Yo, thanks! Here's the board, as promised. I forgot to mention that I don't know how to open the board. It's like it's magically shut!  No matter what I do, I can't seem to get it open. Maybe you have some idea of how to do it?

 You are now carrying the Ouija Board.

>knock on ouija board 3 times
You hear a click. The ouija board is now openable.

>open ouija board
You open the board as you would a book, and see that the inside is intact. It looks like the traditional Ouija Board, with the alphabet, numbers 0-9, "Yes" and "No" at the two top corners of the board. The planchette is fixed to the board in a way so that keeps it from falling off the board when used. Below the numbes, you read "GOOD BYE" in large letters. In the bottom hand corner of the board you read "Property of xxxx xxxxxxxx, Paranormal Investigator". 

 You notice that Luigi comes up from behind you. 

 Luigi: Yo! You got the board open. Try asking the board about the spirit.

>ask ouija board about the spirit
You place your hands on the planchette, and immediately after asking the question, the planchette smoothly moves across the alphabet, spelling "i am here". 

 You can ask the board about the murderer, the paranormal investigator, or the remains.

>ask ouija board about the remains
The planchette does not move for a while. Then, it slowly spells "make a mirror image". 

Luigi: What does it mean, make a mirror image? What is it asking us to do?

>ask ouija board about hint
The planchette spells out "Axes make mirrors. Life and death are mirrors. Young and old, rich and poor.  East and West are mirrors as well. 

 Luigi: Something about east and west???

>north
Forest Clearing
Here there is a lack of trees, giving a view of the stars. In the center of the clearing, there is an oddly symmetrical pond. Now that you look around, you realize that the trees on the perimeter of the clearing seem to mirror each other. 

 You can see two paths on either side of the clearing. West is Western Field, and East is Eastern Field. You can see a cabin up ahead. North is to the cabin's front door. The path South leads to the Campsite.

The perfect-circle pond is serene, and so clear that you can see the bottom. There seems to be nothing alive in the pond.

>north
Cabin
 You enter the abandoned cabin.  The room has peeling walls and a rotten wooden floor. Both seem to be splattered with a dark stain. There is no furniture in the room. 

 North of this room is  a door that must lead to the Attic. East of here is  an open door leading to what looks like a bedroom.  the Bedroom. South is Forest Clearing.

>s
Forest Clearing
Here there is a lack of trees, giving a view of the stars. In the center of the clearing, there is an oddly symmetrical pond. Now that you look around, you realize that the trees on the perimeter of the clearing seem to mirror each other. 

 You can see two paths on either side of the clearing. West is Western Field, and East is Eastern Field. You can see a cabin up ahead. North is to the cabin's front door. The path South leads to the Campsite.

The perfect-circle pond is serene, and so clear that you can see the bottom. There seems to be nothing alive in the pond.

* * *

>e
Eastern Field
There is an interesting formation of trees on the far end of the field.

>chop down oak tree
You have nothing to cut it down with.

>take wooden key
After taking the wooden key, you notice that the planchette begins to move on its own. It spells "You are brave... Now go..."

>n
You can't go that way.

>w
Forest Clearing
Here there is a lack of trees, giving a view of the stars. In the center of the clearing, there is an oddly symmetrical pond. Now that you look around, you realize that the trees on the perimeter of the clearing seem to mirror each other. 

 You can see two paths on either side of the clearing. West is Western Field, and East is Eastern Field. You can see a cabin up ahead. North is to the cabin's front door. The path South leads to the Campsite.

The perfect-circle pond is serene, and so clear that you can see the bottom. There seems to be nothing alive in the pond.

>n
Cabin
 The room has peeling walls and a rotten wooden floor. Both seem to be splattered with a dark stain. There is no furniture in the room. 

 North of this room is  a door that must lead to the Attic. East of here is  an open door leading to what looks like a bedroom.  the Bedroom. South is Forest Clearing.

* * *

>open backpack
You open Backpack, revealing Canteen.

>look in backpack
In Backpack is Canteen.

>x canteen
Canteen is empty.

>take canteen
Taken.

>take backpack
That's fixed in place.

* * *

>enter pond
You step into the pond.

Forest Clearing (on Pond)
Here there is a lack of trees, giving a view of the stars. In the center of the clearing, there is an oddly symmetrical pond. Now that you look around, you realize that the trees on the perimeter of the clearing seem to mirror each other. 

 You can see two paths on either side of the clearing. West is Western Field, and East is Eastern Field. You can see a cabin up ahead. North is to the cabin's front door. The path South leads to the Campsite.

>fill canteen
(with Canteen)
You filled the canteen with the pond water.

* * *

>s
(first getting off Pond)

Campsite
The campsite is surrounded with greenery. In the center of the campsite a roaring camfire blazes. Luigi is lounging around the campsite. He seems to be carrying an old, wooden board of some sort. 

 Your pitched tent is South. North is the Forest Clearing.

>s
Tent
Your backpack sits in the corner. The sleeping bags are unrolled on the ground.

* * *

>knock on ouija board 3 times
You hear a click. The ouija board is now openable.

>knock on ouija board 2 times
You knock twice on the ouija board. Nothing appears to happen

>open ouija board
You open the board as you would a book, and see that the inside is intact. It looks like the traditional Ouija Board, with the alphabet, numbers 0-9, "Yes" and "No" at the two top corners of the board. The planchette is fixed to the board in a way so that keeps it from falling off the board when used. Below the numbes, you read "GOOD BYE" in large letters. In the bottom hand corner of the board you read "Property of xxxx xxxxxxxx, Paranormal Investigator". 

 You notice that Luigi comes up from behind you. 

 Luigi: Yo! You got the board open. Try asking the board about the spirit.

>ask board about the spirit
You place your hands on the planchette, and immediately after asking the question, the planchette smoothly moves across the alphabet, spelling "i am here". 

 You can ask the board about the murderer, the paranormal investigator, or the remains.

>ask board about hint
The planchette spells out "Axes make mirrors. Life and death are mirrors. Young and old, rich and poor.  East and West are mirrors as well. 

 Luigi: Something about east and west???

>talk to luigi
Luigi: Yo! Feel free to ask me about stuff. 

 You can ask Luigi about Tent, Campsite, Board, Himself, Yourself, etc.

>s
Tent
Your backpack sits in the corner. The sleeping bags are unrolled on the ground.

>talk to luigi
You can't see any such thing.

>cut luigi
You can't see any such thing.

>cut tree
You can't see any such thing.

>n
Campsite
The campsite is surrounded with greenery. In the center of the campsite a roaring camfire blazes. Luigi is lounging around the campsite. He seems to be carrying an old, wooden board of some sort. 

 Your pitched tent is South. North is the Forest Clearing.

* * *

>w
Western Field
There is an interesting formation of trees on the far end of the field.

>x trees
You see five identical birch trees (name: Western Birch Trees), all growing in a straight row. On one end of the row of trees, there is a tree stump.

>e
Forest Clearing
Here there is a lack of trees, giving a view of the stars. In the center of the clearing, there is an oddly symmetrical pond. Now that you look around, you realize that the trees on the perimeter of the clearing seem to mirror each other. 

 You can see two paths on either side of the clearing. West is Western Field, and East is Eastern Field. You can see a cabin up ahead. North is to the cabin's front door. The path South leads to the Campsite.

The perfect-circle pond is serene, and so clear that you can see the bottom. There seems to be nothing alive in the pond.

>e
Eastern Field
There is an interesting formation of trees on the far end of the field.

>x trees
You see five identical birch trees (name: Eastern Birch Trees), all growing in a straight row. On one end of the row of trees, there is an oak tree  where, in the Western Field, there is a stump .

>x oak tree
The tall oak tree looks out of place in the Eastern Field.

>chop down oak tree
You have nothing to cut it down with.

>inventory
You are carrying:
  ouija board

>w
Forest Clearing
Here there is a lack of trees, giving a view of the stars. In the center of the clearing, there is an oddly symmetrical pond. Now that you look around, you realize that the trees on the perimeter of the clearing seem to mirror each other. 

 You can see two paths on either side of the clearing. West is Western Field, and East is Eastern Field. You can see a cabin up ahead. North is to the cabin's front door. The path South leads to the Campsite.

The perfect-circle pond is serene, and so clear that you can see the bottom. There seems to be nothing alive in the pond.

>n
Cabin
 You enter the abandoned cabin.  The room has peeling walls and a rotten wooden floor. Both seem to be splattered with a dark stain. There is no furniture in the room. 

 North of this room is  a door that must lead to the Attic. East of here is  an open door leading to what looks like a bedroom.  the Bedroom. South is Forest Clearing.

* * *

>x trees
You see five identical birch trees (name: Eastern Birch Trees), all growing in a straight row. On one end of the row of trees, there is an oak tree  where, in the Western Field, there is a stump .

>chope down tree
That's not a verb I recognise.

>chop down tree
You chop down the oak tree with the axe. From inside the tree, you find a wooden key.

>inventory
You are carrying:
  axe
  ouija board

>chop down tree
You chop down the oak tree with the axe. From inside the tree, you find a wooden key.

>take wooden key
After taking the wooden key, you notice that the planchette begins to move on its own. It spells "You are brave... Now go..."

>x wooden key
A wooden key that came from the tree stump.

>w
Forest Clearing
Here there is a lack of trees, giving a view of the stars. In the center of the clearing, there is an oddly symmetrical pond. Now that you look around, you realize that the trees on the perimeter of the clearing seem to mirror each other. 

 You can see two paths on either side of the clearing. West is Western Field, and East is Eastern Field. You can see a cabin up ahead. North is to the cabin's front door. The path South leads to the Campsite.

The perfect-circle pond is serene, and so clear that you can see the bottom. There seems to be nothing alive in the pond.

* * *

>n
Cabin
 The room has peeling walls and a rotten wooden floor. Both seem to be splattered with a dark stain. There is no furniture in the room. 

 North of this room is  a door that must lead to the Attic. East of here is  the Bedroom. South is Forest Clearing.

>n
(first unlocking the attic door with the wooden key, then opening the door)

Attic
The Attic is dust covered and moldy. In the center of the room, on the floor, lies a paper doll.

* * *

>give canteen to luigi
Luigi: Yo, thanks! Here's the board, as promised. I forgot to mention that I don't know how to open the board. It's like it's magically shut!  No matter what I do, I can't seem to get it open. Maybe you have some idea of how to do it?

 You are now carrying the Ouija Board.

>inventory
You are carrying:
  ouija board

>luigi
That's not a verb I recognise.

>l luigi
It's a your good friend, Luigi.

>ask luigi about axe
There is no reply.

>n
Forest Clearing
Here there is a lack of trees, giving a view of the stars. In the center of the clearing, there is an oddly symmetrical pond. Now that you look around, you realize that the trees on the perimeter of the clearing seem to mirror each other. 

 You can see two paths on either side of the clearing. West is Western Field, and East is Eastern Field. You can see a cabin up ahead. North is to the cabin's front door. The path South leads to the Campsite.

The perfect-circle pond is serene, and so clear that you can see the bottom. There seems to be nothing alive in the pond.

>n
Cabin
You enter the abandoned cabin. North of Cabin is Attic. East of Cabin is Bedroom. South is Forest Clearing.

>n
(first opening attic door)
It seems to be locked.

>s
Forest Clearing
Here there is a lack of trees, giving a view of the stars. In the center of the clearing, there is an oddly symmetrical pond. Now that you look around, you realize that the trees on the perimeter of the clearing seem to mirror each other. 

 You can see two paths on either side of the clearing. West is Western Field, and East is Eastern Field. You can see a cabin up ahead. North is to the cabin's front door. The path South leads to the Campsite.

The perfect-circle pond is serene, and so clear that you can see the bottom. There seems to be nothing alive in the pond.

>s
Campsite
The campsite is surrounded with greenery. You notice an uneven patch of dirt in the ground. 

 Your pitched tent is south.

Luigi is lounging around the campsite. He seems to be preoccupied with reading a strange book.

>talk to luigi
Luigi: Yo! Feel free to ask me about stuff. 

 You can ask Luigi about Tent, Campsite, Himself, Yourself, etc.

>ask luigi about ouija boards
Luigi: See if you can find a way to open it.

>inventory
You are carrying:
  ouija board

>ask luigi about ouija boards
Luigi: See if you can find a way to open it.

>give water to luigi
You can't see any such thing.

* * *

>take canteen
Taken.

>fill canteen
(with Canteen)
You have to be in water to fill it.

>n
Campsite
The campsite is surrounded with greenery. You notice an uneven patch of dirt in the ground. 

 Your pitched tent is south.

Luigi is lounging around the campsite. He seems to be preoccupied with reading a strange book.

* * *

>s
(first getting off Pond)

Campsite
The campsite is surrounded with greenery. You notice an uneven patch of dirt in the ground. 

 Your pitched tent is south.

Luigi is lounging around the campsite. He seems to be preoccupied with reading a strange book.

>talk to luigi
That's not a verb I recognise.

>give luigi canteen
Luigi: Yo thanks! Here's the book, as promised.

 You are now carrying the Ouija Book.

>read ouija book
You flip the pages randomly and arrive at page 3:

You read: " Contacting an Evil Entity. "

>x ouija book
An odd, worn book. The cover reads: Beware of Ouija Boards. There seem to be five pages in the book, though many of the words are smudged and indecipherable.

>read page one
What do you want to read page that in?

>read page one of ouija book
You read: " History of Ouija Boards.  Also known as the Witch Board, the Ouija Board is an ancient tool that was used to form a connection with the departed, from as early as 1100 AD in China. Though controversial, the Ouija Board has gained esteem through its reportings of encounters with spirits, both benign and malicious entities alike."